— !.=<s>
— ).=<s>
— ?.=<s>
— ¡=<s>
— ¿=<s>
$(N. de la T)=Nota del traductor
$[1]=nota 1.
$[10]=nota 10.
$[11]=nota 11.
$[12]=nota 12.
$[13]=nota 13.
$[14]=nota 14.
$[15]=nota 15.
$[16]=nota 16.
$[17]=nota 17.
$[18]=nota 18.
$[19]=nota 19.
$[2]=nota 2.
$[20]=nota 20.
$[21]=nota 21.
$[22]=nota 22.
$[23]=nota 23.
$[24]=nota 24.
$[25]=nota 25.
$[26]=nota 26.
$[27]=nota 27.
$[28]=nota 28.
$[29]=nota 29.
$[3]=nota 3.
$[30]=nota 30.
$[31]=nota 31.
$[32]=nota 32.
$[33]=nota 33.
$[34]=nota 34.
$[35]=nota 35.
$[36]=nota 36.
$[37]=nota 37.
$[38]=nota 38.
$[39]=nota 39.
$[4]=nota 4.
$[40]=nota 40.
$[41]=nota 41.
$[42]=nota 42.
$[43]=nota 43.
$[44]=nota 44.
$[45]=nota 45.
$[5]=nota 5.
$[6]=nota 6.
$[7]=nota 7.
$[8]=nota 8.
$[9]=nota 9.
$0ºC=0 grados centígrados
$180º=180 grados
$360º=360 grados
$45º=45 grados
$90º=90 grados
$AA=doble a
$AAA=triple a
$ABC=éibící
$AC=A C
$Ace=eiz
$ADN=a de ene
$AJ=A  J
$AK=A K
$AK-=A K
$APM=AP M
$AR=A R
$Balance=Balans
$Bella=Bela
$CDs=Ci Dis
$Chance=Chanz
$CO=C O
$Coates=Coats
$Cure=quiur
$Dale=Deil
$Dome=Dom
$DVD=DiViDí
$EC=E C
$EE.=estados
$EE.=estados
$EE=estados
$Gen.=general
$GPS=yipíes
$IH=I H
$II=2
$III=3
$Iman=Aiman
$IRL=I R L
$IV=4
$Jornal=yournal
$Larde=Lard
$Mándela=Mandela
$Mr.=Mister
$Mrs.=Misis
$ºC=Grados centígrados
$PB=Perdido Bich
$Pírate=Pírat
$RPC=erepece
$SA=ese a
$SMS=mensaje
$SOS=S O S
$SR=señor
$ST=SanT
$Sta=Señorita
$TEMPLE=templ
$Temple=templ
$TVA=T V A
$UHF=Uacheefe
$UPS=UPeeSe
$USA=usa
$USB=u esebe
$VHF=beacheefe
$XIX=diecinueve
$X-MP=eX-eM Pi
$XVIII=18
$XX=veinte
$XXIV=24
$XXL=extra extra grande
$XXV=25
$XXVI=26
$XXVII=27
$Yates=Yats
(=<s>
(N. del T.).=nota del traductor
)=<s>
-. ¿= 
...=<s>
—...=<s>
/=<s>
:=<s>
–¡=
¡= 
—¡= 
-¡=<s>
¡Sssh!=Silencio
¿= 
–¿= 
-¿=<s>
—¿=<s>
<<=<s>
=
—=<s>
==<s>
>>=<s>
·=<s>
1 hora=una hora
12h.=12horas
1º parte=1ª parte
21 horas=ventiún horas
22h.=22horas
24h=24 horas
31 horas=30 y un horas
31/10/81=31 del 10, del 81,
41 horas=40 y un horas
48h=48 horas
51 horas=50 y un horas
61 horas=60 y un horas
71 horas=70 y un horas
81 horas=80 y un horas
91 horas=90 y un horas
A.T.=AT
ª=<s>
AA=ah ah
Aaah=áahh
Aaay=Aaa ay
Aagje=Agje
Aahh-hh-men=Aaaa -men
Aaron=Aron
Aarón=Arón
Aaronson=Aronson
Aashif=Aschif
AB=A B
Abberline=Aberlin
Abby=Aby
Abe=Abi
Abelson=Abel son
Abou=Abu
AboundSound=Abund Sound
Abrams=Abraams
ABS=A B S
ACE=eis
Achille=Achil
Achterhuis=Acteruis
Ackerley=Ackerly
Ackermann=áckerman
Ackley=Ackly
Acqua=Aqua
Acupuncture=Acupunctur
ACV=A, Ce, uve
Adam=ádam
Adare=Adar
Adélaïde=adeláida
Adenauer=Ade nauer
Adirondacks=Adiron dacks
Adley=Adly
ADSL=AD SL
Adventure=Advénchur
Advertiser=Advertaiser
Adviles=Advils
Ælfwine=alfwin
Aérea=Aerea
AF=A F
Afghanistan=Afghanistán
Again=Aguein 
Agneau=Agneu
Agnew=Agniw
Agrippa=Agripa
Aguanbabuluba=Aguanba buluba
Agway=Acgwey
Ahab=Ajab
Ahaz=Ajaz
Ahonen=Aonen
AI=A I
Aï=Aí
ÁIex=áhlex
AIlan=Alan
Aileen=Ailin
Ainulindalë=Ainulindal
Airlines=érlains
Airplane=eirplein
Airstream=Airstrim
Airways=er weys
Airworld=eirguold
AJC=A J C
Akallabêth=Akallabth
Akasha=Akacha
Akers=eikers
Akihide=jAkhid
A-l=A ,1
Aladdin=Aladín
Alagaësia=Alagasia
Al-Andalus=Al Andalus
Alanne=Alane
Alastair=Alastir
Albaicín=Albacín
Albano=Albáno
Albany=álbany
AlberCo=Alber Corporeichon
Alberta=álberta
Albus/Ron:=Albus Ron:
-Albus/Ron:=-Albus Ron:
Alderaan=Alderan
Alderwood=Alderwud
A-L-E-R-G-I-C-O-S-A-L-A-S=ALERGICOS ALAS
Alex=álex
AlexAinhoa=AlexAin oa
Alfie=Alfi
Alfred=álfred
Algarve=Algarvi
Algerie=Algeri
Algernon=álger non
Al-Golan=Al Golan
Alice=Aliss
Aline=Alin
Alison=álison
Alistair=Alistar
Alkmaar=Ahlhcmar
Allagash=Alagash
Allah=Alah
Allan=Alan
Allegheny=Alegheny
Allegrini=Alegrini
Allen=Alen
Allen's=Alen's
Alley=Aly
Allie=Ali
Allison=álison
Allium=Alium
Alloy=Aloy
Ally=Aly
Allyson=Alisón
Alohamora=Alojo mora
Alphonse=Alfóns
Altair=altahir
Altaïr=Altair
Althea=Altea
Altitude=Altitud
Always=elgúheis
Alyce=Alyz
Alyson=álison
AM.=AM
AM=AM
Amalie=Amalia
Amarone=Amaron
Amazon=áhmazón
Ambrose=Ambros
AMC=A M C
America=América
American=Américan
Americans=Américans
Amersfoort=Amersfort
Amherst=eimerst
Ammas=Amas
Amstellaan=Amstelán
Amstelveenseweg=ámstel vénseweg
Amway=Amwey
Amy=eimy
ANACIN=ANACíN
Anaheim=Anaé im
Anaïs=Anaís
Anakin=Anakín
Andraitx=Andraix
Andrei=andréi
Andress=Andrés
Andrew=ándru
Andrews=ándrius
Androscoggin=Andros coyin
Andy's=Andys
Angeles=ángeles
Angelicus=Anyelicus
Angelina=Anyelina
Angelo=ányelo
Angels=enyels
Angelus=ányelus
Angie=Anyi
Anica=ánica
Anja=Anlla
Ann=An
Anna=Ana
Annabelle=Anabell
Annandale=Anandal
Annapolis=Anapolis
Anne=Ane
Année=Anné
Anneliese=Anelís
Annette=Anett
Annie=Ani
Annotation=Anotación
Anns=Ans
Annslee=Ansli
Annsley=Ansly
Annual=Anual
Anorak=Anórak
Anthony=ánthony
Anthropological=Anthropolóllical
Antibes=ántibes
anti-Caine=anti-kein
anti-Isaac=anti Isac
Antilly=ántilly
Antoine=ántoin
Antonio=antonío
Apocalypse=Apocalyps
Apollo=Apolo
Apollolaan=Apololan
apologize=apoloyais
Apostate=Aposteit
Apple=Apol
Applegate=Apulgueit
Apples=Apls
April=eipril
Apsley=Apsly
Arashi=Arachi
Arbitron=árbitron
Archaide=Archaid
Architectural=Arqhitectural
Archives=Archivs
Arcueil=Arcuel
Ardrey=Ardry
are=ar
Área=area
Argent=Aryent
Argyle=Argyl
Aris=Arhis
Arkham=Arkam
Arkie=Arki
Arkwright=Arku gright
Arlene=Arlen
Arlington=arlingtón
Armbruster=Arm bruster
Armstrong=Amstron
ARN=A R N
Arnie=Arni
ARNm=A R Nm
Arnold=árnold
Aroosto=Arosto
Aroostook=Arostuk
around=araund  
ARPTNA=ARP TNA
Arrington=árrinton
Arrington=árrinton
Arrowhead=Arow jed
Art3mis=Artemis
Arthur=árthur
Artie=Arti
Arts=Arths
ARWEN=ARguhEN
Arwood=Arwud
Asahina=Asaina
Ash=Ach
Ashbury=ásbury
ASHER=ách ER
Ashes=Aches
Ashley=Asly
Ashran=Ach rran
Asperger=Asperguer
Assante=Assant
Associated=Asociaded
Associates=Asociats
ASSOCIATION=ASSOCeichON
Astaire=Astair
Astrid=ástrid
Astrosmash=Astrosmach
Asurbanipal=Asur banipal
AT=A T
Atomic=Atómic
Atreides=Atreids
Attenborough=Atenburugh
Attleboro=Atlboro
ATV=ate ve
Atwood=Atgud
Aucourt=Aucort
Audrey=Aúdrey
Augie=Augi
Augmentine=Augmentin
Augurey=áugury
Auguste=August
AUGUSTINE=AUGUSTíN
Aurore=aurora
Auschwitz-Birkenau=Auschwitz Birkenáu
Aussenkommando=Ausen komando
Auuuuuu=Auu
Avenue=Avenú
Avery=eiviry
Aviation=Aviachion
AVIEMORE=AVIEMOR
Avon=Avón
Away=Awey
Axe=Ax
Azkaban=Azkabán
Babies=beibis
Bacon=beicón
Baedecker=Bedeker
Baenre=Benri
Bagshot=Bacshot
Baidoo=Baidu
Bailey=Baily
Baileys=Beilys
Bakaara=Bakajará
Bake=Bak
Baker=Beker
Bakersfield=Bakers field
Baldacci=Baldaci
Baldracci=Baldraci
Balfour=Balfur
Ballroom=Balrum
Bally=Baly
Baltimore=Baltimor
Bamboo=Bambú
Banbury=Bámbury
Bane=Bein
Bangkok=Bang kok
BANGLADESH=BáNGLADEgcH
Bangor-Brewer=Bangor Bréwer
Bangor-Bucksport=Bangor Bucksport
Bannennan=Banenan
Bannerman=Banerman
Banning=Baning
Barbara=Bárbara
Barbate=Barbat
Barbecue=Barbecué
Barbie=Barbi
BarbieKen=Barbi Ken
Bárdossy=Bárdosi
Bargain=Bargein
Barksdale=Barksdeil
Barley=Barly
Barney=Barny
Barnhelm=Barnelm
Barnnum=Bárnum
Barrett=Barret
Barringer=Barrinyer
Barrington=Baring tón
Barrow=Barow
Bartholomew=Bartholo mew
Bartley=Bartly
Barun-Urt=Barún Urt
BASIC=béisic
Bassem=Basén
Bastille=Bastill
Baterman=Báter man
Battle=Battl
Battlestar=Battll star
Battletech=Battl tech
Battlezone=Battl zon
Baudelaire=Baudelair
Baudelaires=Baudelairs
Bauhaus=Baujaus
Bay=Buy
Bayh-Dole=Bayh Dol
Bayonne=Bayonn
Bayou=Ba you
Bayshore=Baychur
BDSM=B D SM
Be=Bi
Beach=Bich
Beacon=Beicón
Beakman=Bekman
Beam=Bim
Bean=Bin
Beanie=Beani
Bean's=Bin's
Bear=Bir
Beardmore=Berdmor
Beardstown=Beardstawn
Bears=Bers
Beasley=Beasly
Beatles=biruls
Beatrice=Beatriz
Beatson=Betson
Beauce=Beaús
Beaulieu=Beauliu
Beautiful=Biutiful
Beauty=Biuty
Beaver=Bíver
Beaverbrook=Baverbruk
Beavis=Bevis
Bebelaire=Bebelair
Becca=Beca
Beckley=Beckly
BeeBee=Bee Bee
Beech=Bich
Beefaroni=Bifaroni
Beefy=Bify
Beekman=Bekman
Beeline=Belin
Beeman=Biman
been=ben 
Beepers=Bipers
Beer=Bir
Beerseba=Beersebá
Beethoven=Betoven
Beethovenstraat=Bethovenstrat
Beetlegeuse=Bitl yeus
Beetles=biruls
Before=Bifor
Begin=Bellin
Behind=Bijaind
Beighley=Beighly
Beijing=Beying
Bekleidungskarnmer=Beklei dungs karmer
Bel-Aire=Beler
Belchertown=Belcher ton
Belgrave=Belgrav
Bellamy=Bélamy
Bellatrix=Belatrix
Belleau=Béleau
Bellegnífica=Belegnífica
Bellevue=Belevue
Bellows=Belows
Bellson=Bélson
Bellsqueeze=Belsquiz
Benjaman=Benja man
Benjamin=Benjamín
Benjamin's=Benjamín's
Benji=Benlli
Benners=Beners
Bennet=Benet
Bennett=Benett
Bennie=Beni
Benno=Beno
Benny=Beny
Bentley=Bentli
Beppy=Bepy
Bérégovoy=Beréc ovoy
Berg=Berc
Bergdorfs=Berg dorfs
Bergdorf's=Berg dors
Bergenfield=Bergenfeld
Berger=Berguer
Bergeron=Bergerón
Berkeley=Berkéley
Berkley=Berkli
Berkshires=Berkchirs
Bernhard=Bernárd
Bernie=Berni
Bernstein=Bernstéin
Bertie=Berti
Bertinelli=Bertineli
Bertus=Bertús
Besame=Bésame
Bessemer=Besemer
Bessey=Besy
Bessie=Besi
Bestie=Besti
Betadine=Betadín
Bethesda=Betésda
Bette=Bett
Better=Beder
Betty=Bety
Bettye=Bety
Beverly=Béverly
Beware=Bewar
Beyoncé=Biyonz
Bianchi=Bianchi 
Bibelforschers=Bibel forchers
Bible=Baibl
Bicharón=Bicharon
Bicycle=báisicol
Biddeford=Bidford
Bieber=Biber
Bienville=Bienvill
Bierce=Bierz
Biergarten=Bergarten
Bigfoot=Big fut
Bigs=Bigcs
Biiibe=Bibe
Bijou=Biyou
Billie=Bili
Billings=vlinks
Billy=Bily
Billy-Boy=Bily-Boy
Biltmore=Biltmor
Binghamton=Bing jamton
Biology=Bioloyi
Birdwhistell=Bird whistell
Birkenau=Birckenau
Birmingham=Birmingam
Birsfelden=Birs felden
Biscayne=Biscayn
Bishop=Bichop
Bisson=Bison
Bissonette=Bisonet
BISTURÍ=BiSTúRí
Bitburg=Bitbur
Bitterbuck=Bit buck
Bitterbucle=Biderbucl
Björn=Biór
B-l=B , 1
Blacke=Black
Blackie=Blacki
Blackwood=Blackwud
Blade=Bleid
Blake=Bleik
Blakey=Blaky
Blakie=Blaki
Blankevoort=Blank evort
Blejwas=Blej was
Blenheim=Blen heim
Bloemendaal=Blomendal
Blondie=Blondi
blood=blaad
Blood=Blod
Bloody=Bludy
Bloombingdale's=Blumbingdeils
Bloomington=Blomingtón
Bloomsbury=Blónsbury
Blueberries=Bluberis
Blueberrys=Bluberys
Bluefin=Blufin
Bluetooth=Blutut
Bluffs=Blufs
Bluie=Blui
Blume=Blum
Blurry=Blury
Blushsephine=Blúsephin
BMA=BeeMeA
BMW=be emedoble u
Board=Bord
Bobby=Boby
Bodies=Bodis
Bogie=Bogi
Bohai=Bojai
Bohemian=Bohemia
Boise=Bois
Bolkestein=Bolkestéin
Bollinger=Bolinyer
Bolyson=Bólyson
Bombay=Bombáy
Bones=Bons
Bonjour=Bonyour
Bonnefort=Bonefort
Bonneville=Bon vill
Bonney=Bony
Bonnie=Boni
Booker=Bhuker
Bookin=Bukin
Boomslang=Bumslang
Boon=Bon
Boone=Booni
Boorman=Burman
Boot=Bot
Booth=Buth
Boothbay=Buthbey
Borchgrevink=Borc grevink
Boris=Bóris
Borne=Born
BORRË=BORRe
Bossa=Bosa
Bossey=Bosy
Bostonian=Bostoniun
BOSTON-PORTLAND=BOSTON PORTLAND
Botany=Bótany
Botticelli=Botichéli
Boudier-Bakker=Budir-Bácker
Boudreau=Boudreu
Bougeois=Boulleois
Boulevard=Bulevard
Boulogne=Boulogn
Boulogne-sur-Mer=Boulogn-sur-Mer
Bouloir=Boloir
Bounty=Bunty
Bourdonplace=Bourdonpleiz
Bourgeois=Bourgeus
Bourke=Bourk
Bourne=Burn
Bowery=Bouery
Bowie=Bogui
Bowle=Bowl
Boyce=Boiz
Boyles=Boihlhs
Boyne=Boyn
Brace=Breiz
Bracermunn=Braser mun
Bradbury=Brádbury
Braddock=Bradock
Bradley=Bra dli
Brady=Bradi
Braezinsky=Brezinsky
Brain=Brahin
Branch=Brangch
Brann=Bran
Brannigar=Branigar
Braquialgas=Branqui algas
Brassov=Brasov
Brattle=Brattl
Brattle-Chance=Brattl -Chanz
Braunschweiger=Braun schweiger
Bravern=Braven
Braves=Bravs
Bread=Bred
Breaking=Briking
Breckenridge=Brecken ridch
Breeze=Briz
Breivogel=Breivoyel
Bremmer=Bremer
Bremmers=Bremers
Brennan=Brenan
Brennert=Brenert
Brett=Bret
Brewster=Breuster
Brian=braian
Brianna=Briana
Briarcliff=Brearcliff
Brice=Braís
Brickhill=Brickjill
Bridgeport=Braidchport
Bridgewater=Bridg uater
Bridgton=Bridton
Briggs=Brics
Brigham=Brigam
Brigitte=Brigitt
Brinkley=Brinkly
Brisbane=Brisbein
Briscoe=Brisco
Bristol-Myers=Bristol Mallers
British=Britich
Britney=Britny
Brittney=Brittny
Brochette=Brochet
Brock=Bruck
Broderick=Bróderick
Brompton=Bromton
Brontë=Bronti
Brook=Bruk
Brooke=Bruk
Brookings=Brokins
Brookings-Smith=Brokins Smith
Brookins-Smith=Brokins-Smith
Brookline=Bruklin
Brooklyn=Bruklyn
Brooklyn-Queens=Bruklyn Quhins
Brooks=Bruks
Brookshire=Bruck chir
Broomfield=Brumfiel
Brosey=Brosy
Brothers=Broders
brought=brout 
Brower=Brouér
Browery=Brouery
Brown=Bráun
Browne=Brown
Browning=Bróunin
Bruce=Bruss
Brucie=Bruci
Brundage=Brundach
Brunner=Bruner
Bryan=Braian
Bryce=Brayz
Bryson=Braison
BSA=B, S A
Buaaah=Buuaah
Buccieri=Bukcheri
Buckaroo=Buckarú
Buckeye=Buckey
Buckinghamshire=Buckingjamchir
Buddha=Buda
Buddinger=Búdinller
Buddy=Budy
Budgie=Budgi
Budweiser=Budguaiser
Buffalo=Búfalo
Bug=Búg
Bullet=Bulet
Bulletin=Buletin
Bullmoose=Bulmus
Bullock=Bulock
Bullwinkle=Bullguhinkli
Bülow=Bulow
Bunny=Buny
Buntline=Buntlin
Burakku=Buraku
Burgers=Burguers
BurgerTime=BurguerTaim
Burghley=Burgley
B-U-R-K-E=B-U-R-K-E, 
Burlingame=Burlingam
Burlington=Búrling ton
Burney=Burny
BURNHA=BURNA
Burning=Búrning
Burse=Burs
Burton=Búrton
Burtonnaq=Burtonaq
Burton-naq=Burtonaq
Burwel=Burguel
Bush=Buch
Bushido=Buchido
Buttered=Butered
Butterfly=Buter flay
Butthead=Butjed
BUUUMMMM=BUMMMM
Buy=Bay
Buyenna=Buyena
Buzzcocks=Buzz cocks
Bye=Bai
Byron=Bairon
c.c.=centímetros-cúbicos
CAAAARRRIIIEE=CAAAARRRIII
Caaathy=Caty
Cacique=Cácique
Caddy=Cady
Cadillac=Cadilac
Cadillacs=Cadilacs
Cagney=Cagny
Caine=Cain
Caine=Càin
Caitlin=queitlin
cajon=cajón
cajones=cajónes
Caldwell=Cal duel
Caldwellia=Calduela
Caliban=Calibán
Calizo=Cálizo
Callahan=Cálajan
Callaway=Calaguhay
callejones =callejhones 
callejones=callejhones
Calling=Caling
Cally=Caly
Calzaslargas=Calzas largas
Cámaro=Camaro
Cambray=Cambráy
Cambridee=Cambrid
Camelot=Cámelot
Camille=Camill
Campbell-Westlind=Campbell-West lind
Camptown=Camptawn
Camry=Canry
Canaán=Canán
Canada=Canadá
Candide=Candaid
Candlelighter=Candlighter
Candleton=Candledton
Canley=Canly
Cannes=Canes
Cannes-Look=Canes-Luk
Cannon=Canon
can't=kent 
CANTERBURY=CANTERBúRY
CANTIL=CaNTíL
Canyon=Can yun
Cape=Cap
Capitol=Captol
Capleville=Capel vil
Capone=Capon
Cappi=Capi
Cappy=Capy
Caprice=Capriz
Capture=Captur
Caray=Caráy
Carbide=Carbid
Carbine=Carbin
Carbondale=Carbondel
care=ker
CaribeAir=Carib eir
Caride=Carid
Carietta=Carieta
Carlijn=Carlijin
Carlton=Carton
CARMICHAEL=car máikol
Carnegie=Carneyi
Carnie=Carni
Caroline=Caro lain
Caronte=Caront
Carpenter=Cárpenter
Carpezzi=Carpezi
Carr=Car
Carranque=Carránque
Carrey=Carey
Carriage=Carriach
Carrie=Carri
Carroll=Cárrol
Carthage=Carthach
Cartier=Carter
Casaescondite=Casa escondite
Cascade=Cascad
Cascades=Cascads
Casey=Casy
Cash=Cach
Casper=Cásper
Cassidy=Cásidy
Cassie=Casi
Castaways=Castaweis
Castie=Casti
Castle=CástEl
Castlemora=Castlmora
CastleRock=Castl Rock
Castleton=Castelton
Castonguay=Caston guhEI
Catamount=Catamaunt
Catcher=Cathcher
Cate=queit
Caterpillar=Cáterpilar
Catherine=Catherin
Cathy=Caty
Catitude=Catitud
Catskills=Cats kils
Cáucaso=Caucaso
Caulfield=Caulfild
Cause=Cous
'cause=Kas 
Cave=kaib
Caveau=Cavéu
Cavell=Cavel
Cavenaugh=Cavnaugh
Cayce=Cays
CCE=CC E
CD=sidí
CD-ROM=CíDí-ROM
Cedric=Cédric
Centerville=Centervill
Centipede=Centiped
Century=sénchuri
Cessna=Cesna
C'est=Cest
Cezanne=Cezan
Chakross=Chakros
Challenge=Chalencshh
Challenger=Chalinyer
Chalon-sur-Saône=Chalon sur Saon
Chamberlain=Chamberlán
Champagne=Champáña
CHAMPVILLE=CHAMPVIL
Chancellor=Chanselor
Chandiramani=Chándirarmani
Chandler=Chan dler
Chaney=Chani
Change=Chang
Channey=Chany
Chantay=Chanty
Chapelwaite=Chapelwait
Chapp=Chap
Chappaquiddick=Chapaquidick
Chardonnay=Chardony
Charge=Charg
Charger=Chárjer
Charity=Cháriti
Charlaine=Charlain
Charlene=Charlin
Charles=Charls
Charleston=Charlestun
Charlestown=Charhles tawn
Charley=Charly
Charlie=Charli
Charlize=Charliz
Charlotte=Charlott
Charlton=Charton
Chase=Cheis
Chateaugay=Chataugay
Chatelier=Chatelir
Chatterton=Cháter ton
Chattooga=Chatoga
Chauncey=Chaunci
Cheap=Chip
Cheerio=Cherio
Cheerios=Cherios
Cheese=Chis
Cheetos=Chetos
Cheever=Chiver
Cheez-Doodles=Chiz Dodls
Chelsea=Chelsy
Cherie=Cheri
Cherinowski=Cherinoski
Chernobil=Chernóbil
Chernóbil=Chérnobíl
Chesapeake=Chespeak
Cheshire=Chesir
Chessman=Ches man
Chesterfield=Chesterfild
Cheun=Chéun
Chevette=Chevet
Chewbacca=Chwbaca
Cheyenne=Cheyene
Cheyne-Stokes=CheynStoks
chhh=chiss
Chi=Chhi
Chicca=Chica
Chiete=Chiet
Chikurishvili=Chikurishvil
Child=Chaild
Childress=Chaildres
Chimney=Chimny
Chinatown=Chainataun
Chinook=Chinuk
Chinooks=Chinuks
Chippendale=Chipendeil
Chippers=Chipers
Chloe=Cloe
Chocula=Chócula
Choice=Chois
Choirelli=Choireli
Choo=Cho
Chris=Cris
Chrisque=Chisque
Chrisse=Chisse
Christ=Crist
Christensen=Crístensen
C-H-R-I-S-T-I-A-N=CRISssssTIAN
Christian=Cristiahn
Christie=Cristi
Christine=Cristin
Christmas=Cristmas
Christopher=Cristofér
Christy=Cristy
Chrysler=Crísler
Chryslers=Crislers
—Chs=chis
—Chss=chis
—Chsss=chis
Chsss=Sscilencio
Chsss=Sscilencio
—Chssss=chis
chssss=chiss
—Chsssss=chis
chsssss=chiss
Chuck=Chuc
Chuckie=Chucki
Chug-Chug=Chung Chung
Chumley=Chumly
CIA=SíA
Cincinatti=Cincinati
Cincinnatí=Cincinati
Circle=circull
Citerea=Citeréa
Citgo=Cidgo
Claaaaudiaa=Claaaaudia
Claggert=Clagert
Claiborne=Claiborn
Claire=Clair
Clancy=Clansy
Clannahan=Clanan
Clare=Clar
Clarence=Clarenz
Clarendon=Cláren dón
Clarice=Clariz
Claridge=Clarid
Clarisse=Clariss
Clarke=Clark
Clarksburg=Clarksburc
CLASESScorpius=CLASES, Scorpius
Clastle=Clastl
Claude=Claud
Claudel=Claudél
Claudine=Claudin
Claymore=Claymor
Clayton=Cleyton
Clean=Clin
clear=kliar 
Clearwater=Cler huater
Cleary=Clery
Cleaver=Cliver
Cleaves=Cleavs
Clepsidra=Clep sidra
Clete=Clet
Cleveland=Clíveland
Cline=Clin
Clinique=Cliniqk
Clipper=Cliper
Clitemnestra=Clitem nestra
Clive=Cliv
Clooney=Cluny
Cloppenburg=Clopenburc
Clouse=Clous
Clouseau=Closeu
Clyde=Clyd
CNEI=C NEI
CNN=C N N
Coast=Cost
Cochran=Coch ran
COCINAHARRY=COCINA, JARRY
Cocoa=Cocoh ah
Coelho=Coélo
Coffee=Coffi
Coffey=Coffy
Coffey-para=Coffy para
Cofy=Coffey
cojones=cojhones
Coke=Coka
Coldplay=Col pley
ColecoVision=Coleco Visión
Coleman=Cóleman
Coleridge=Colerid
Colette=Colet
Collection=Colection
Colleen=Colin
College=Colech
Collier=Coyer
Collin=Colin
Collins=Colins
Collop=Colop
Colloportus=Coloportus
COLOMBE=COLOMB
Coltrane=Coltran
Coltsmore=Coltsmor
Colucci=Coluci
Colville=Colvill
Comerse-a-Kieran-Gallagher=Comerse a Kier Galláguer
Comes=Coms
Commando=Comando
Comment=Coment
Committee=Comite
Commodore=Comodor
Commonwealth=Comun wealth
Commoriom=Comoriom
Communist=Comunist
Communist-Jewish=Comunist-Jewish
Community=Comunity
como?=hcomo?
Compazine=Compazin
Computer=Compiuter
Conciergerie=Conciergeri
Conestoga=Constoga
Confederate=Confedereit
Confederates=Confederats
Connecticut=conericutt
Connection=Conection
Connell=Conell
Connelly=Conely
Conner=Coner
Connery=Conery
Conneticut=Cóneticut
Connie=Coni
Connolly=Conoly
Connor=Cónor
Conservancy=Conservansy
Consolidated=Consolideided
Conspiracy=Conspirasy
Constance=Cónstans
Constantine=Constantin
Construction=Construchon
Continuum=Continum
Contribution=Contribuchon
Convenience=Conveniens
Converse=Convers
Conway=Conwey
Cook=Cuk
Cookie=Coki
Cool=Cul
Cooley=Couly
Cooleyville=Colyvil
Coombs=Cumbs
Cooney=Cony
Coonts=Conts
Co-op=Cop
Coors=Cors
Coorter's=Corters
Coose=Cos
Copertone=Cóperton
Copper=Cuper
Copperfield=Coperfild
Coppertone=Coper ton
Corey=Cory
Corleone=Corlaion
Corlies=Corlis
Corniche=Cornich
Cornwallis=Cornwalis
CORPORACION=CORPORACIóN
Corporate=Corporeit
Corporation=Corporechon
Correcional=Correccional
Corrigan=Corigan
Coruscant=Coruscan
Corvair=Corvar
Corvette=Corvett
cosa-Regan=cosa Rigan
Cosmoline=Cosmolain
Cosmopolitan=Cosmo pólitan
Cote=Cot
Cotlrell=Cotrel
Cottonwood=Cotonwud
Cottrell=Cotrel
COUGARS=CUGARS
could=kood 
Countdown=Cont daun
Counter=Conter
County=Cunty
Courier=Curier
Courthouse=Courtous
Courtnee=Courtnii
Courtney=Courny
Courtyard=Courtllard
Cove=Cov
Cowgirls=Cow guirls
Cowles=Cowlis
Cowslaw=Cows law
Cow-vaca=Cou vaca
CPO=CePeO
CPU=cepe u
Crabbe=Creib
Craig=Craik
Craine=Crain
Crandall=Crándall
Crandell=Crándel
Crane=kRehiN
Cranepool=Cranpul
Cranham=Cranjam
Crapp=Crap
CRAPPER=CRAPER
CRASH=CRAgcH
Cratzchbarken=Cratch berken
Cream=Crim
Credence=Credens
Creed=Cred
Creedence=Credens
Creek=Crek
Cremadequeso=Crema de queso
Cressler=Cresler
Cressner=Crésner
Crimestoppers=Craimestopers
Cripp=Crip
Crippen=Cripen
Cristian=Cristians
Cristophe=Cristop
Croce=Croc
Crommert=Cromert
Crommett=Cromett
Cronkite=Cronkit
CROOK=CROK
Crosskill=Cros kill
Croton-on-Hudson=Croton-on-judson
Crouch=Cruch
Crowe=Crow
Crowell=Cróuuel
Crowley=Crówly
Crown=Croún
Crue=Cru
Cruella=Cruela
Cruise=Cruis
Crunch=Crunsch
Crusoe=Cruso
Crutchfield=Crutch fild
Cry=cray
Cthulhu=C tulu
Ctonia=Ce tonia
Cuisine=Cuisin
Cullen=Culen
Culture=Cultur
Culverton=Culvertón
Cumberland=Cumber land
Cummings=Cumins
CUMPLAÑOS=CUMPLEAÑOS
CUMPLEAROS=CUMPLEAñOS
Cunnilingus=Cunilingus
Curie=Curi
Curtain=Curtein
Curval=Cuúhrvál
Cuthbert=Cutbeert
Cutie=Cuti
Cutter=Cuter
Cuuuuu=Cuúúú
CYBERCOM=cibercom
Cycle=saicl
Cygni=signi
Cygnus=Cignus
Cyllan=Cilan
Cymbeline=símbelin
Cyn=sin
Cyndi=sindi
Cynthia=sintia
Cypress=sypress
Cyrano=syrano
Cyrus=sirius
Czerny=zerny
Daala=Dalá
Daan=Dan
Dachau=Dáchau
Dade=Dad
Dadle=Dále
Daewoo=Daéguw
Dafegó=Dafégo
Daggorath=Dagohrath
Dagwood=Dagwud
Dahlgren=Dalgren
Dahlia=Dalia
Daily=Deily
Daisy=Deisy
Dallas=Dalas
Dallin=Dalin
Damen=Déimen
Damien=Dámien
Dance=Danz
Dandridge=Dandridch
Dane=Dan
Daney=Dany
Danielle=Danielli
DanIQn=DanIn
Dannegger=Daneguer
Danniker=Dániker
Dannon=Danon
Dannto=Danto
Danny=Dany
Danone=Danon
Dantine=Dantin
Darcy=Darsy
D-A-R-D-O-S-V-E-N-E-N-O-S-O-S=DARDOS VENENOSOS
dark=daerk
Darlene=Darlen
Darnielle=Darniel
Darrel=Dárrel
Darzelle=Darzel
Dashner=Dásner
Dauphine=Dauphin
Dave=Dav
Davey=Davy
David=déivid
Davidson=Deibidson
Davies=Davis
Davis=Deivis
Day=Dei
Days=Deys
DEA=DéA
Deacon=Deicón
Dead=Ded
Deagan=Digan
Deanna=Deana
Dearborn=Derborn
Death=Deth
Deathmatch=Dethmatch
Debbie=Debi
Deborah=Débora
Dee=Dí
Deeber=Diber
Deeds=Dids
Deegan=Digan
Deenie=Deni
Deep=Dip
Deere=Deer
Deerhide=Derhid
Deering=Dering
Dees=Des
Defuniak=Defun iak
Degauss=Degáus
DeGroot=DeGrot
Deirdre=Dirdre
Déjà vu=Déyà vu
Dejadla=Déjala
Dejanovic=Deyanovic
Deke=Dek
Dekka=Deka
Delacour=Delacur
Delacroix=Delacrox
Delaney=Delany
Delaware=Delawar
Delete=Delet
Deliveries=Deliveris
DeLorean=De Lorean
Delphine=Delphín
Delphy/Hermione:=Delfy germaiony:
-Delphy/Hermione:=-Delfy germaiony:
Deluxe=Delux
Demiguise=Demiguis
DeMille=DeMil
Dempsey=Dinpsy
DeNatale=DeNatal
Denise=Denis
Denker=Déquer
Denning=Dening
Dennings=Deningsh
Dennis=Denis
Dennison=Denison
Denny=Deny
Denouement=Denóu ément
Denoument=Denou ment
Densaugeo=Dénsaugeo
Denzel=Dénzel
Depot=Dipot
Depp=Dip
Depression=Depresión
Derbyshire=Derbychir
D-E-R-R-O-C-A-M-I-E-N-T-O=derrocamiento
Derwent=Der went
DESGRANGES=DéSGRáNgcS
Desirée=Desiré
Dessau=Desáu
Dessler=Desler
Detroit=Ditroit
Deutsches-Aufrustungswerk=Deusches Aufrustun gwerk
Deutschlandsender=Deutsch land sender
Devarney=Devarny
Devil=Dévil
Devlin=Dévlin
Devonshire=Devonchir
DevøraLibros=DevoraLibros
Dew=Diú
DeWitt=De Witt
D-F=D F
d'Herelle=derelle
Diamond=Daimond
Diamondback=Daimond back
Diane=Dian
Dickens=Dickéns
Dickie=Dicki
Dido=Daido
Dieppe=Dip
Dieu=Diu
Digest=Dighest
Digests=Diguets
Diggory=Dígori
Diggpry=Digpry
Digorry=Digory
dijo-Ha=dijo Ha
Dillinger=Dilínger
Dillon=Dilon
Dilly=Dily
DiMaggio=DiMagio
Dimmart=Dimart
Dimmesdale=Dimsdeil
Dimmy=Dimy
Dinah=Dina
Dinsmore=Dinsmor
Dionne=Dion
Dios-Cerdo=Dios Cerdo
DIRECTORALA=DIRECTORA, LA
Disabilities=Disabilitis
Disclosure=Disclausur
Disney=Disny
Disodine=Disodín
Disraeli=Disraelí
Dissections=Disekchions
Distinguished=Distinguiched
Distortion=Distortcion
Distracted=Dístracted
Dixie=Dixi
Dixieland=Dixiland
Dizzy=Dizy
Dmitri=Dimitri
Dmsnrore=Demsnror
Do you have?=Du iu jav? 
Dockerty=Dokerti
Dodd=Dod
Dodge-.=Dodye-.
Dodge=Dodch
Dodger=Dodller
Dodgers=Dodyers
Dogg=Dog
Dohay=Dojay
Doherty=Doerty
Doke=Doki
Dokes=Dokis
DOMITORIO=DOrMITORIO
Donahue=Donahué
Donaldsonville=Donaldsonvill
Donatello=Donatelo
Done=Don
Donkey=Donky
Donna=Dona
Donna-Rose=Dona Rous
Donne=Doni
Donner=Doner
Donni=Doni
Donnie=Doni
Donnigan=Donigan
Donny=Dony
Doo=Du
Dood=Dud
Doofus=Dufus
Dooley=Doly
Dooley's=Dolys
Doolittle=Dólittle
Door=Dor
Doors=Dors
Dope=Dop
Doppler=Dopler
Doragon=Doragón
Dorchester=Dorches ter
Dorsey=Dorsy
Dostie=Dosti
Double=Doubl
Doubles=Dubles
Douce=Dous
Doug=Duc
Dough=Dugh
Douglas=Duglas
Douglass=Duglass
Dove=Dov
DoveBar=Dov Bar
Dover=Dóver
Downeast=Downist
Downey=Downy
Doyle=Doilll
Dra=Doctora
Draaake=Dreiik
Draake=Dreiik
Dragoon=Dragon
Drake=Dreik
Drake-Brittney=Dreik-Brittny
Drakes=Dreiks
Drakey=Dreky
Drambuie=Drambui
Dreadnaught=Dread naught
Dream=Drim
Dreamcatcher=Drim cath cher
Dreamland=Drimland
Dressler=Drésler
Driftwood=Driftwud
Drive=Draiv
Driver=Draiver
Drove=Drov
Drugstore=Drugstor
Drummer=Drumer
Drummond=Drumond
Drummore=Drumor
Dry=Dray
Drysdale=Drísdel
Duane=Duain
Dubay=Dubáy
Duce=Duz
Duchesne=Duchesni
Duddie=Dudi
Duddits=Dudits
Dudley=Dúdley
Duff=Duf
Dufresne=Dufres
Duganfield=Duganfild
Duke=Duk
Dumbledore=Dumbledor
Dumledore=Dumledor
Dunbarger=Dunbaryer
Dune=Dun
Dunes=Duns
Dungeon=Dunyeon
Duninger=Duninyer
Dunn=Dun
Duplissey=Duplisy
Duquesne=Duquesn
Durbeyfield=Durbeyfild
Durchgangszimmer=Durch gangs zimer
Dursleys=Durslys
Dussault=Dusault
Dussel=Dusel
DVD-ROM=DíVíDí ROM
Dwayne=Dwayn
Dyer=Daier
Dyke=Dyk
Dympna=Dymna
DynaGirl=Dyna Guirl
E. Z.=e z
Eagle=igl
Eagles=iguels
Eames=Eams
Earthworld=Eartguord
Easier=Esier
Easley=Easly
Eastern=Estern
Eastwood=East wud
Eaton=Eiton
Eberhard=Eberard
Ebey=Eby
Ebook=Ebuk
Eccles=Ecles
Eckleburg=Eklburg
ECM=eceeme
EcoBacter=Eco Bacter
Ecoline=Ecolain
Economiste=Economist
ED-die=ED di
Eddie=Edi
EDDIES=EDDIS
edge=ech
Edgecombe=Edyecomb
Edison=Edisón
Edite=Edite
Edward=Eduard
Edwards=Eduards
EEIPH=E E I PH
Effinger=Efinger
EHABER=dE HABER
Eichmann=Eigchman
Eiffel=eiffél
Eileen=Elen
EÍlie=Eli
Eisenhower=Eisen jawer
Elaine=Elain
Elara=élara
Eldridge=Eldrid
Eleanor=Eleonor
Eleanora=eleanóra
Electrawoman=Electra woman
Eleven=ileven
Elfer=élfer
Elfriede=Elfried
Elias=elías
Elise=Elis
Elizabide=Elizabid
Ellaine=Elain
Elle=Eli
Ellen=Elen
Ellery=Elery
Ellie=Eli
Elliman=Eliman
Ellington=Elinton
Elliot=éliot
Ellison=élison
E-L-L-I-S-O-N=éLISON
Ellsworth=Elsworth
Ellsworth-Beroza=Elswhort Beroza
Ellum=Elum
Eloise=Elohís
Else=Els
Elsie=Elsi
Elte=Elt
Elwood=Elgud
Elyse=Elys
Emancipator=Emancipeitor
Emerson=émerson
Emile=Emil
Emma=Ema
EMMC=EM MC
Emotional=Emocional
Empire=émpair
Empori=enporí
Emporium=Empórium
empujones=hempujonehs
ENCYCLOPEDIA=ENCiCLOPEDIA
Endogenos=Endógenos
Endogenous=Endógenous
Energy=Enerlly
England=éngland
English=énglich
Englishman=English man
English-speaking=English-spikin
Engstrom=Engs trom
Enguirer=Enguir
Ennie=Eni
Ennis=Enis
Enterprise=Enterprais
Enterprises=Enterpraises
entregamos-Albus=entregamos. -Albus
Eppenstein=Efenstein
ePub base r1.0=ePub base, revisión 1.0
ePub base r1.2=ePub base, revisión 1.2
ePub r1.0=ePub revisión 1.
Equitable=Equitabl
Eragon=Eragón
Eressëa=Eresea
Erewhon=Ereguhón
Erica=érica
Erie=Eri
Ernest=érnest
Ernie=Erni
Errol=Erol
Erskine=Erskin
Erville=Ervill
Escalade=Escaleid
ESL=Ejército simbiótico de liberación
E-S-M-E=ESME
Esoobac=Esobac
Esperantum=Esperántum
Esquire=Esquir
ESR=E, S, R
Essen=Esen
Esskommando=Eskomando
ESTACION=ESTACIóN
ESTAN=ESTáN
Estates=ésteits
Estes=estés
Estígea=Estígéa
Estragon=Estragón
ET=E T
Ethan=Etan
Étienne=Étien
Ettie=Etti
Eugene=Euyin
Eugénie=Eulléni
Eugley=Eugly
EuroDisney=Euro Disny
Europe=Europ
Evanescence=Evan esens
Evangel=Evánllel
Evangeline=Evanyelín
Evanston=Evanstón
Evansville=Evansvill
Evelyn=évelyn
Evening=Evning
Ever=éver
Everdeen=Everdín
Everglades=Everglads
Evergreen=Evergrin
Everlastíng=Ever lastíng
Evermore=Evérmour
Everquest=Evercuest
every=Evry 
Everything=Evri-zing 
Everywhere=Everywher
Evie=Evi
Evinrude=Evinrud
Evvie=Evi
Ewie=ewi
Excedrin=Excedrín
Excuse me=Exkius mi
EXECUTE=EXEquiut
Exeter=Exter
Exhibition=Exhibichon
Expedition=Expedichión
EXPLOSIVES=EXPLOSIVS
Expressway=Expreswey
Extransensorial=Extra sensorial
EXTRARRADIO=EXTRA RADIO
Extrême=Extrim
Exxon=Exon
Eye=ai
Eyes=ays
Eyewitness=aiwitness
Eyre=Eyr
Face=Feis
Factico=Fáctico
fading=faireng 
Fail-Safe=Fail-Saf
Fairlane=Fairlan
Fairmont=Feir mont
Fairview=Feir viu
FAIWELL=FAI WELL
Fallonme=Falon mi
Falls=Fals
Falmouth=Falmout
Family=Fámily
FANNY=FANY
Fantasy=Fántasy
Farmall=Farmoll
Farmington=Farming ton
Farquahr=Farquar
Farr=Far
Farrakhan=Farrakán
Fashion=Fachión
Fate=Fat
Faulkner=Faulner
Fay=Fey
Faye=Fay
Fayette=Fayett
Fayetteville=Fayettevill
FBI=FB I
FDA=F D A
FDE=F D E
Fëanor=Fenor
Fear=Fir
fear=fir  
Fearon=Feron
Features=Féachurs
Feel=fil
Feketehalmy-Zeisler=Feket jalmy Zeisler
Felix=Félix
Fellegvar=Felegvar
Fenway=Fenwey
Ferdinand=Férdinand
Fergie=Ferlli
Fever=Féver
Feynman=Feyman
FFFSTB=FSTB
Field=Fild
Fielding=Filding
Fierville=Fiervill
Fíese=Fíes
Filosoof=Filosof
Finch=Finhch
Finchley=Fincly
find=faind
Fine=Fain
Finegold=Faingold
Fingertips=Finguertips
Finn=Fin
Fiorri=Fiori
fire=faer
Fire=Fahir
Firebird=Fairbird
Firefly=Firflai
Firenze=Fairenz
Firestone=Fairston
Fireworld=Firworld
Fish=Fich
Fisher=Fícher
Fiske=Fisk
Fitzgerald=Fitzyerald
Five=faib
Fizzing=Fizing
Fläcken=Flacken
Flacutono=Flacutonó
Flagley=Flagly
Flags=Flacs
Flair=Flar
Flanagan=Flanagán
Flannery=Flanery
Flapper=Flaper
Flash=Flach
Flashdance=Flash dans
Flatwoods=Flatguds
Fleegle=Fligle
Fleet=Flit
Fleetwood=Flitwud
Florence=Florens
Florida=Florída
Florville=Florvil
Fly=Flai
Flyer=Fliyer
Flynn=Flyn
Fokker=Fóquer
follow=Faloo  
Folly=Foly
Fontainebleau=Fontainbleu
Fonzie=Fonzi
Foods=Fuds
Foolish=Folish
Foot=Fut
Footloose=Fotloos
Force=Forz
for-Cry=for-Crai
Forever=For ever
Forge=Forch
Forlines=Forlins
Forrest=Forest
Forrester=Forest
Forri=Fori
Fort-Lauderdale-Hollywood=Fort Lauderdal jolywud
Fortune=Fortun
FORUM=FóRUM
FOTOTO=<s>
Foundation=Foundachion
Foundry=Fundry
Fourier=Furier
Fournier=Fourniér
FRANÇAIS=FRANcAIS
France=Franz
Fráncfort=Fránfort
Franchute=Franchut
Francia=Fráncia
Francie=Franci
François=Francois
Françon=Fránçon
Frane=Fran
Frankenberry=Franknberry
Frankengato=Fránkengato
Frankie=Franki
Franny=Frany
Frascati=Fráscati
Fraudusuaria=Fraudu suaria
Frechette=Frechett
Freddie=Fredi
Freddy=Fredy
Frederickson=Fredericksón
Fredie=Fredi
Fredrerick=Frederick
Freed=Fred
Freedman=Fridman
Freedy=Fredy
Freeman=Friman
Freemantle=Frimantl
Freemont=Frimont
Freeport=Friport
Freeze=Friz
Frehley=Frely
French=Frensdh
Frenchman=Frensh man
Frenchman's=Frenschman's
Freneau=Freneu
Fresh=Fresch
Freuhof=Freujof
Friday=Fraidey
Frieda=Frida
Friedman=Frid man
Frígate=Frígat
Frigate=Frigueit
Frilly=Frily
Fringe=Fringch
Frisbee=Frisbi
Fritchie=Fritchi
Frobozz=Fróboz
Fromme=From
Froot=Frot
Fruity=Fruit
Frumenti=Frument
Frune=Frun
Fry=Frai
Frye=Frai
Fryeburg=Fraiburg
Fucci=Fuzi
Fuegovirus=Fuego virus
Fuengirola=Fuenllirola
Führer=Fúrer
Führerin=Fuhrerin
Fuhrerstube=Fuhrerstub
Fukushima=Fukuchima
Fuller=Fuler
Funcoot=Funcot
Fundation=Fundachion
Fünfhausen=Funjausen
Funicello=Funicelo
Furtive=Furtiv
Future=Fiúk chur
FVW=FV dobleú
GABA-A=GABA A
Gabanna=Gabana
Gable=Gabll
Gabriel=Gabriél
Gabrielle=Gabriel
Gacey=Gasy
Gacy=Gasy
Gadget=Gadyet
Gage=Gueich
Gaggia=Gagia
Gaines=Gains
Gainesville=Gainesvill
Gainsley=Gainsly
Gakko=Gako
Galactica=Galáctica
Galahad=Galajad
GALAXY=GáLAXY
Galbreath=Galbrith
Gale=Gail
Galeazzi=Galeazi
Gales=Gals
Galilei=Galiléi
Gallagher=Gallaguér
Gallahan=Galajan
Galleazzi=Galeazi
Gallery=Gálery
Galliano=Galiano
Gally=Galy
Galorium=Gálorium
Galveston=Gálveston
GAME=Gueim
Games=Gueims
GAMMA=GAMA
Ganimedes=Ganímedes
Gannett=Ganett
Gannett-Cumberland-Androscoggin=Ganet Cumberland Androscoguin
GARCIAPARRA=GARCíA PARRA
Garfunkel=Garfun kel
Gargajo=Gárgajo
Garrett=Gárrett
Garrish=Garris
Garroway=Garo wey
Gaststube=Gasttub
Gaulle=Gaull
Gauloises=Gauloses
Gazette=Gazett
Gbost=yi bost
Gear=year
Geddy=yeddy
Gedney=Gedny
Gedreau=Gedreu
geek=yek
Geer=Guer
Geeta=Geta
Gee-yat=Gi-yat
Geheime=Gejeime
Gehenna=Gena
Gehringer=Gérinyer
Geiger=Geiguer
Geiringer=Geirin ger
Gelderman=Geldermen
Gelderman-Oso=Gélderman Oso
Gellerman=Gelerman
Gemini=yemini
Gemma=Gema
Gemstone=Gemston
gen.=gen
Gendanken=llendanken
Gene=yene
Generation=Generation
Genesis=Génesis
Genevieve=Genevive
Genghis=Gengis
Genie=Geni
Gentryville=Gentryvill
Geocaching=Giocaching
Geoff=giof
Geoffroi=géofroi
Geographic=yiográfic
George=yorch
Georges=llorchs
Georgetown=yorshtawn
Georgette=yoryet
Georgia=yorya
Georgie=yoryi
Georgina=yoryina
Gerald=yerald
Geraldine=yeraldín
Geralt=yeral
Gerber=Guerber
Gerbrandy=Gérbrandy
GerdHenreidse=GerdHenreids
Gergeti=llerlleti
Germain=yérmain
Germaine=Germain
Germantown=llerman tawn
Gernisavien=Gernisávin
Gernold=llérnold
Gerritsen=Gerritsén
Gerrnain=yerrnain
Gertrude=Gertrud
Gesell=yisell
Gestapo=Gestápo
Getty=Guetty
Gettysburg=yettysbur
Gevers=Ghevers
Gforce=G fors
G-Force=G-Forz
Ggande=Gande
Ghana=Gana
Ghuurrkh=Ghurrkh
Gianelli=llianeli
Giatrakou=Giatraku
Gibbons=Guibons
Gibson=Guibson
Gideon=yideón
Gideon-antes-conocidocomo-el-creído-insufrible=Gideon-antes-conocido como-el-creído-insufrible
Gienelli=Gineli
Gifford=Guifford
Gift=Guift
Gifts=Guiffs
Gigeure=Gigeur
Gilbert=llilbert
Gilbey's=Gilbys
Gilchrist=Gilchirist
Gilles=Giles
Gillespie=Gilespi
Gillette=yilet
Gilliam=Giliam
Gillian=yilian
Gilligan=Guíligan
Gilly's=Gilys
Gilmore=Guilmor
Gina=yina
Gina-Sue=llina-Súe
Ginelli=Gineli
GINGY=GINjY
Ginny=yiny
Giny=lliny
Giovanni=yovani
Giraffe=yiraf
Girl=Guirl
Girls=guirls
Giuseppe=yisepp
Givens=Guivens
GK=lliKa
Gladstone=Gladston
Glaggert=Glagert
Glassman=Glasman
Gleason=Glison
Glendale=Glendal
Glenmorangie=Glenmorangi
Globe=Glob
Gloucestershire=Gloussterchir
Gloves=Glovs
Glue=Glu
Gmail=yi mail
Gnggs=guengues
Go=Gou
Gobstones=Gobstons
God=Gad
Gödel=Godel
Godfrey=Gudfri
GODRICRON=GODRIC, RON
God's=Gad's
Godunov=Gódunov
Godzilla=Godzila
Goebbels=Gobels
Goering=Góering
Goethe=Goeth
Goettleman=Gottleman
GoFast=Gou Fast
Goldberg=Gold ber
Goldfish=Goldfich
Golding=Gholding
Goldmann=Goldman
Goldwater=Gold guhater
Gólgota=Golgotá
Gollum=Gólum
Gone=Gon
Gonna=Gona
Good afternoon=Guud after-nuun 
Good bye=Guud bai
Good morning=Guud morning 
Good night=Guud nait 
Good=Gud
Goodman=Gudman
Goodnough=Gudnough
Goodrich=Godrich
Goods=Guds
Goodwin=Gudwin
Goof=Gof
Goofy=Gufi
Goohan=Gojan
Gooks=Guks
Goose=Goosi
Gordius=Gordus
Gore-Tex=Gor-Tex
Gorham=Gorjam
Göring=Góring
Görz=Gorz
Gosselin=Goselín
got=gat
Gotthold=Gotjold
Goyle=Goyl
Graaf=Graf
Grace=greh is
Grace-dijo=Greis -dijo
Gracie=Graci
Graham=Grajam
Grahame=Grajam
Grahame-Smith=Grajam esmith
grail=grael
Grancourt=Grancurt
GRANDVIEW=GRANDVIW
Grane=Grein
Grange=granyer
Granger=Grenyer
Granger-Weasley=Grenyer Wisly
Granite=Granit
Granny=Grany
Grassner=Grasner
Grateful=Gratful
Gray=Grey
Grayboys=Grey boys
Grayle=Grayl
Graynemeir=Greynemer
Great=Gret
Greedo=Gredo
Greeley=Greely
Greely=Grely
Greenback=Grenback
Greenblatt=Grinblatt
Greene=Greni
Green-Eyed=Green-eiyed
Greenfield=Grinfild
Greenlaw=Grinlaw
Greenleaf=Gren lef
Greeno=Greno
Greenspan=Grinspan
Greenspant=Grinspant
Greentree=Grintri
Greenwood=Grinwud
Greer=Grer
Greezy=Grezy
Gregarious=Gregarius
Gregor=Grégor
Gregory=Grégori
Gregson=Gricson
Grenadeau=Grena diu
Grenadeaus=Grena deus
Grenfelí=Grenfil
Grenoble=Grenobl
Grenouille=Grenouil
Grenville=Grenvill
Grese=Gres
Gresham=Grécham
Grete=Gret
Gretel=Grétel
Greybearde=Greybirde
Greyhound=Grayyjoun
Greystock=Greys tock
Greystoke=Greystok
Grievance=Grievanz
Griggs=Grix
Grille=Grilli
Grimes=Grims
Grimm=Grim
Grimmer=Grimer
Grimphook=Grimphok
Grimwood=Grimwud
Grinch=Grincch
Grinnell=Grinel
gritándole-Albus=gritándole. -Albus
Groatley=Groatly
Grotley=Grotly
Grove=Grob
GROVEPOINT=GROVPOINT
Grozdik=grosdic
Grüne=Grun
grupos-Son=grupos. Son
Gruyère=Gruyèr
G-Shock=G-chock
Guadalhorce=Guadal jors
Gucci=Guci
Guckenheimer=Gucken jeimer
Guile=Gail
Guillain-Barré=Guilán Barré
Guinness=Guiness
Guipúzcoa=jipúzcoa
Gujral=Gural
Gulfstream=Gulfstrim
Gulliver=Guliver
Gulptilil=Gultihlil
Gummi=Gumi
Gump=Gamp
Gunnarsson=Gunarson
Gunney=Guny
Guns=Gans
Gunsmoke=Gunsmok
Gutenberg=Gutenber
Guthrie=Guthri
GW=jedoble u
Gwenafra=Guhenafra
Gwendolyn=Guhéndolin
Gwenny=Guhiny
h.=horas
Haaaarry=jaaaarry
Haaarry=Jaaarry
Häagen-Dazs=Haghen-Dazs
Haakon=jakón
Haarlem=járlem
Haas=jas
Habashaw=jabashaw
Hackensack=yaquensack
Hackman=jackman
Hackney=jackny
Hackstein=jackstein
Had=jad
Hadeon=adeón
Hadji=jadji
Hadley=jadly
Haeftling=jaftling
Hagar's=jagar's
Haggar=Hagar
Hagid=jágrid
Hagrid=jágrid
Hagstrom=jags trom
Hague=jaguhí
Hahn=jan
Hahnemann=janeman
Haijac=jaijac
Hailsbury=jails bury
Haines=jaines
Hairspray=eir sprey
Haizman=jaizman
Haji=jaji
Hajnal=jajnal
Hake=jak
Hal=jal
Halcydonia=Halci donia
Haldeman=jaldeman
Haldol=jaldol
Hale=jale
Haley=Jaly
Halfweg=jalfeg
Halleck=jálleck
Hallettsville=Hallettsvill
Halley=jaly
Halliday=Jólidei
Halligan=jáligan
Hallmark=jallmark
Hallorann=jáloran
Halloween=jalouín
Hallyfax=jalyfax
Halo=jalo
Haloween=Jálowin
Halsey=Halsy
Halverson=jalverson
Ham=jam
Hamavet=jamavet
Hamburgo=amburgo
hamburguesa=amburguesa
hamburguesas=amburguesas
hamburguesería=amburguesería
Hamelin=jamelin
Hamelín=jamélín
Hamíl=jamíl
Hamill=jamill
Hamilton=jámilton
Hamiltoniano=jamiltoniano
Hamlet=jamlet
Hammer=jamer
Hammersmith=jamersmith
Hammond=Jámond
Hammy=jamy
Hampden=jampden
Hampshire=jampchir
Hampton=jampton
Hamptons=jamptons
hámster=jámster
Hancock=jancock
Handbook=Hand buk
Handel=jandel
Händel=jandel
HANDLER=jANDLER
Hands=jands
Hanes=jans
Hang=jang
Hank=jank
Hanks=janks
Hannah=jana
Hanne=Hane
Hannegan=janegan
Hanneli=janeli
Hannibal=Hanibal
Hannigan=janigan
Hanning=janing
Hanoi=janoi
Hanrahan=janraján
Hanratty=janraty
Hanscom=jánscom
Hansel=jansel
Hansell=jansell
Hansen=jansen
Hansford=jansford
Hanson=janson
Hansonville=jansonvill
Hanta=janta
Hantel=jantel
Hapes=japes
Happen=japen
Happy=japy
Happytime=jappy taim
Hara=jara
Harald=járald
Harar=jarar
Harbor=jarbor
Hard=jard
Harder=jarder
Harding=jarding
Hardsdale=jards deil
Hardu=járdu
Hardware=jardh wer
Hardwick=jardwick
Hardy=jardy
Harford=jarford
Hargensen=Jargénsen
Hargreaves=jargrevs
Harkonnen=Harkonen
Harlan=jarlan
Harlandale=jarlándeil
Harlem=jarlen
Harley=Jarly
Harley-Davidson=jarly- Devidsón
Harlow=jarlow
Harmony=harmoni
Harnorview=jarnorviw
Harol=járol
Harold=jarold
Harper=jarper
HarperCollins=járperColins
Harper's=jarper's
Harrelson=járelson
Harriet=Jarriet
Harrington=jarrinton
Harris=jarrís
Harrisburg=jarrisburk
Harrison=jarrison
Harrods=jarods
Harry/Voldemort:=jarry Voldemort:
-Harry/Voldemort:=-jarry Voldemort:
Harry/Voldemort=jarry Voldemort
Harry=jarry
HARRYHarry=jARRY, jarry
Hart=jart
Hartford=jartford
Hartlib=jartlib
Haruhi=harhuí
Harvard=járvard
Harvester=jarves
Harvey=jarvy
Hasgtrom=jástrom
Hasse=jass
Hassler=jasler
Hasty=jasty
Hatcher=jádcher
Hatfield=jatfield
Hathor=jator
Hatter=jatter
Hattie=jati
Hauptsturmführer=jaups turm fuhrer
Hause=Haus
Haussman=jaús man
Haute=jaut
Have=jav
Havelock=javlock
Haven=Jeiven
Haverstrom=javers trom
HAVING=jeving
Hawai=jawai
Hawái=jawái
Hawaii=jawai
Hawes=jawes
Hawg=jawg
Hawk=jaúc
Hawking=jawkin
Hawkins=Jawkins
Hawksbill=jawksbill
Hawse=jawsi
Hawthorne=jawthorni
Hax=jax
Hayakawa=jayakawa
Hayao=Háillaju
Hayata=jayata
Haycraft=jaycraft
Hayden=jayden
Hayer=jayer
Hayes=jayes
Hayley=jayley
Hayman-Reichling=jayman Reischling
Hays=jays
Haytham=jey tham
Hayworth=jayworth
Hayzari=jai zari
Haze=jaz
Hazel=Jéizel
Hazlett=jazlett
Hazzard=jazard
HBO=HB hó
head=jead 
Headroom=jed drom
Heads=jeads
Health=jealth
Hearst=jearst
heart=jart
Heath=jeath
Heathcliff=jeathcliff
Heather=Hither
Heathman=jithman
Heathrow=getraw
Heaven=jeven
Hebbel=jebel
HÉBÉ=HÉh BÉ
Heckler=jécler
Hedges=jedges
Heebert=jebert
Heer=jeer
Hefty=jefty
Heidegger=jeide guer
Heidi=jeidi
Heights=jeights
Heil=jeil
Heilig=jéilic
Heiling=jeiling
Heimlich=jéimlich
Heine=jein
Heinlein=jeinlein
Heinrich=jénrich
Heinz=jeinz
Heisenberg=jeisen ber
Helen=jelen
Helene=Helen
HéléneMorange=jélén Morangh
Helga=jelga
Heline=jelin
Helix=jélix
Hell=jell
Helleborus=jeleborus
Hellfire=jelfir
Hello=je lou
Hello=Jelou 
Hell's=jel's
HELMUT=jELMUT
Helmuth=jelmuth
Helpdesk=jelbddesk
Helpful=jelpful
Helquist=jelquis
He-Man=ji-Man
Hemilich=jehmilich
Hempshire=jempchir
Hendrasen=jéndrasen
Hendricks=jendricks
Hendrickson=jendrick son
Hendrix=jendrix
Heniy=jeniy
Henk=jenk
Henle=jenli
Henley=jenly
Henlow=jenlou
Henreid=jénrid
Henri=jenri
Henriette=jenríet
Hensbroek=jens broek
Henson=jenson
Henty=jenty
Hepburn=jepburn
Herald=jerald
Herb=jerb
Herberg=jerber
Herberi=jérberi
Herbert=jerbert
Hercules=ércules
Here=Her
Herk=jerk
Herk's=jerk's
Herman=jerman
Hermann=jerman
Hermie=jermi
Hermione=germaiony
Hermionne=jérmaiony
Hermitage=Hermitach
HERMOINE=jérmaiony
Hero=jiro
HEROE=HéROE
Herold=jarold
Herschel=jérschel
Hersey=yersy
Hersloquesea=jers loquesea
Hertfordshire=jertfordchir
Herts=jerts
HERV=jERV
HERV-DL=jERV DL
Hervey=jirvi
Herz=jerz
Hesse=jes
Hessen-Kassel=jessen- Keissel
Hessler=jésler
Hesso=jesso
Heston=jeston
Het=jhet
Heul=jeul
He-Wei=je-Wei
Hewitt=jewitt
Hewson=jewson
Heydrich=jeydrich
Heyerdahl=jeyerdahl
Heyster=jeyster
HEYWOODS=jEYguDS
H-Feed=jai-Fed
HFPU=acHe F  P U
Hickock=jickock
Hickok=jickok
Hickory=jickory
Hicks=jicks
high=jai
Higham=jaigham
Highgate=jighgat
Highlands=jaigh lands
Highsmith=jig smith
Hight=jaight
Highway=jaighwey
Hilary=jilary
Hilda=jilda
Hildebrand=jildebrand
Hill=jill
Hillary=jílary
Hillcrest=jil crest
Hiller=jiler
Hillerich=jillerich
Hilliard=Hiliard
Hills=jils
Hillsboro=jilsboro
Hillsborough=jillsborugh
Hilmer=jilmer
Hilton=jilton
Hilux=jaylux
Hilversum=jilversum
Him=jim
Himmelhoch=jimelhoch
Himmler=jimler
Hines=inés
Hiney=jiny
Hinley=jinli
Hipwell=Hipuel
Hiroshima=Hirochima
Hirshhorn=jirson
Hitchcock=jitc cock
Hitchens=jitchens
Hitchin=jit chin
Hitler=jitler
Hitlers=jitlers
Hizzoner=jizoner
Hmm=Hemm
Ho=jo
Hobart=jobart
Hobbit=jóbit
Hobson=llopson
hockey=joky
Hodge=jodge
Hodgkin=jodgkin
Hoeven=joeven
Hoffschneider=Hofsnider
Hoffstetler=jofstétler
Hofman=jofh man
Hofnager=jofnager
Hog=jog
Hogan=jogan
Hogan's=jogan's
Hogsmeade=jogsmeid
Hogwarts=jawarts
Hogwler=jowler
Hoinc=joinc
Hokkaido=jokaido
Holborn=jolborn
Holden=jolden
Holder=jolder
Holdings=joldincs
Hole=jol
Holen=jolen
Holiday=jólidey
Holkham=jolkham
Holland=joland
Hollander=jolander
Holländer=jolander
Hollanders=Holanders
Holliday=jólidey
Hollins=jolins
Hollis=jolis
Hollow=jolow
Holloway=jóloway
Holly=joly
Holmes=jolms
Holoway=jólowey
Holsapple=jols apl
Holston=jolston
holy=joli 
Holyoke=jóllok
HOMBBRES=HOMBRES
Homecoming=joncoming
Homelands=Homlands
Homer=Jomer
Homes=joms
Honeydukes=joney duks
Honeymoon=jony mun
Honeywell=jony well
Honvéds=jonvéds
Hooch=joch
Hood=jud
Hook=jok
Hoops=ups
Hoosier=jósir
Hooters=juters
Hoover=júver
Hooverville=jovervill
Hopalong=jopalong
Hope=jop
Hopkins=jopkins
Hopley=joply
hora=orha
Horace=Horas
Horan=joran
Horchow=jorchow
HORLICKS=jORLICKS
Horn=jorn
Hornet=jornet
Horrocruxes=Horocruxses
Horseshoe=jorchu
Horst=jorst
Hortense=Hortens
Horthy=jorthy
Hoshino=joshino
Hoskins=joskins
Hosler=jósler
Hossanna=Hosana
Hot=jat
HotCock=Hot Cock
Hot-Cock=jot- Cock
HotCock007=Hot Cock 007
Houdini=joúdini
Houghton=jóugh ton
Houlton=joul ton
Hound=jound
Hour=ahuer
Hourglass=auer glass
Hourigan=jourigan
Houston=jiuston
Hovey=jovey
How are you?=Jau ar iu? 
How do you feel?=Jau du iu fil?
How much?=Jau mach? 
How?=Jau? 
Howard=joward
Howardinterpreta=joward interpreta
Howdy=joudy
Howel=jowel
Howell=jowell
Howey=jowey
HOWGARTS=jaward
Howie=jogui
Howland=jowland
Howler=jowler
Hoxon=joxon
Hoxton=joxton
Hoyse=yoys
Hoyt=joyt
Hubba=Huba
Hubbard=jubard
Hubert=jubert
Hubie=jubi
Huchette=juchet
Huck=jucc
Huckleberry=juck leberry
Hud=jud
Huddie=jádi
Hudson=yudson
Huey=juey
Huffington=Hufing tón
Hufflepuff=Huflepuf
Huffy=jafi
Huggies=joguis
Hugh=jugh
Hughes=jughes
Hugues=jugues
Hula=ula
Hule=jul
Hulk=julk
Hulks=julks
Hull=jull
Humanity=iHumanity
Humbarr=jumbar
Humboldt=jumboldt
Hume=jum
Hummel=jumel
Hummer=jumer
Hump=jump
Humperdinck=jumper dinck
Humperton=jumperton
Humphrey=jumphrey
Humphries=jumfries
Humpty=jumpty
Humvee=jumvi
Humvees=Humvis
Hunger=júnguer
Hunington=juninton
Hunsche=junsch
Hunstiville=junstvil
Hunt=junt
Hunter=Junter
Hunters=junters
Huntingdon=juntingdon
Huntington=junting ton
Huntsville=Huntsvill
Hur=jur
Hurricane=Hurican
Hurst=jurst
Hurt=jurt
Hush=juch
Husky=jusky
Hustler=justler
Hut=jat
Hutchett=júd chet
Hütte=jütte
Hutton=jutton
Huxley=juxley
Hyacinth=jyacinth
Hyams=jiams
Hyannis=yanis
Hyde=jyd
Hydroelectric=Hydro eléctric
HYPERION=iPERIóN
Hyundai=iúndai
I am=Ai am 
I am=Ai am 
I have=Ai jav 
I think so=Ai zink so
I would like=Ai would laik
I’m sorry=Ai am sorri
Iapetus=ápetus
Ice=aiz
iceberg=aizbérc
Iceman=ais men
Idaho=áidajo
IdleHands=Idl jands
Idol=aI dol
IDQ=íDeQú
I-Drive=ai draiv
ÍGNEO=ÍGNéO
Iinterior=Interior
IJmuiden=Imuiden
I'll=ael 
Illinois=Ilinois
i'm=am 
imac=ai mac
Image-Eye=Imach ay
IMAX=aIMAX
Imhotep=Imotep
Immelmann=Imelman
Immersive=Immersiv
impresión=impresióhn
Inc=Inch
inch=ench 
Independence=Independenz
Indianapolis=índianapolis
Indico=índico
Industries=Industris
Infantry=Infantrai
Ingalls=íngals
Ingles=Inglés
Inmarsat=ínmarsat
Inn=In
Innovative=Innovativ
Innsbruck=Insbruck
Inside=Insaid
Institute=Institut
Intelligencer=Inteligencer
Intellivision=Inteli visión
Interactive=Interactiv
International=Internáchional
Io=ío
IOI=Indústrias Innovatívas en línea
Iooss=luss
Iowa=ai owa
ipad=ai pad
iphone=ai fon
I-R-I-S-A-A-C-N-E-W-T-O-N=IRISAAC NiuTON
IRM=I R M
I-rOk=ái rrOk
Iron=aIron
Irvine=Irvin
Irwin=irguhin
Isaac=Isac
Isaacs=Isacks
Isaacson=Isacson
Isabella=Isabela
Isa-Edwart=Isa -Edwart
Ishamel=Isamel
Ishmael=Ismael
Isidore=Isidor
Islington=Islinton
Isolder=aisoldr
Israëlskade=Isralkad
It is bad=It is bad
It is good=It is guud
It is here=It is jíer
It is there=It is der
It is=It is 
it=et 
Italy=ítaly
ITU=I T U
IVA=impuestos de venta adjuntos
Ivanhoe=Ivanho
i've=aev 
Ives=Ivs
IY=I Ye
Izabella=Izabela
Jace=Jeis
Jack=llack
Jackie=yaqui
Jacksonville=Jacksonvil
JACK-you-BOYS=JACK yu BOYS
Jacob=Yé icob
Jacobs=yéicops
Jacobsen=yacopsen
Jacobson=yacob son
Jacque=llaque
Jacqueline=lláquelin
Jacqui=yaqui
Jacubois=Jacubis
Jacuzzi=yacúsi
Jada=yada
Jaden=yaden
Jadis=yadis
Jag=yag
Jagger=yáguer
Jaguar=Jáguar
Jahns=yahns
Jake=yeik
Jakeli=llákeli
Jakobs=yeicops
Jamal=yàmal
James=lleims
Jamie=yami
Jamieson=Jamison
Jamilla=yamila
Jammy=Yamy
Jan=yan
Janas=yans
-Jane,=yein
Jane=yein
Janeiro=llaneiro
Janet=yanet
Janetta=yanetta
Janette=yanett
Janice=yaniz
Janiceps=llanicéps
Janina=llanina
Janine=yanine
Janis=yanis
Jankowski=yankowski
January=yanuary
Januká=Jánúka
Jar=yar
Jared=yared
Jarrold=Jarold
Jase=yeis
Jasmine=llasmín
Jasón=lleisón
Jason=yeíson
Jasper=yasper
Java=Jhava
Javelins=Jávelins
JAY=yeY
Jayce=llays
Jayne=yayne
Jean-Claude=yehan Claud
Jeanne=yean
Jeannie=yeani
Jean-Paul=yen-Paul
Jed=yed
Jedi=Yedi
Jeff=llef
JEFFERSON=yéFERSON
Jeffersonville=Jeffersonvill
Jeffrey=llefry
Jekyll=yekyll
Jell-O=yell-O
Jem=yem
Jen=yen
Jenkins=yenkins
Jenks=yenks
Jenn-Aire=yen Air
Jenner=yener
Jennifer=llenifer
Jennifers=yenifers
Jennings=yenings
Jenny=yeny
Jeopardy=yeopardy
Jeppson=yipson
Jer=yer
Jeremiah=lléremi
Jeremy=lleremy
Jerjes=yerjes
Jerry=yerry
Jerry's=yerrys
Jersey=llersy
Jerusalem's=Jerusaléns
Jes=yes
Jess=yess
Jessamyn=Jesamín
Jessica=yésica
Jéssica=yésica
Jessie=yessi
Jesus=Jesús
jets=
Jetta=yetta
Jezz=yez
Jezzie=yezi
Jill=yill
Jim=yim
Jima=yima
Jimbo=yimbo
Jimi=yimi
Jimmie=yimi
Jimmy=yimy
Jimmy-Ricks=llimy Ricks
Jimmy's=yimys
Jims=yims
Jinn=yinn
Jip=llip
Joachin=Joachín
Joan=yoán
Joanie=yoani
Joanna=yoana
Joanne=yoan
Jobs=llobs
Jocelyn=yócelyn
Jodi=yodi
Jody=yody
Joe=yoi
Joel=yoél
Joelle=Joell
Joellen=Joelen
Joellyn=Joelyn
Joep=yoep
Joe's=yoi's
Joey=yoy
JOHANNA=yOHANA
Johannes=llohanes
Johansgate=yohansgueit
Johanssen=yojansen
Jóhn=John
Johnnies=Johnnis
Johnny=Johny
Johnsbury=Johns bury
Jointner=yoiner
Jolander=Jólander
Jolie=yuli
Jolley=Joly
Jomeini=Jomeni
Jon=yon
Jón=yón
Jonas=yonas
Jonathan=yónathan
Jonesie=Jonesi
Jonesport-Beals=Jonesport-Bals
Jonesy=yónsi
Jonesy-Gray=Jonesy-Grey
Jonh=yonh
Jonneke=Jonek
Jonny=yony
Jon's=llon's
Jonson=yonson
Jonsson=yonson
Joop=llop
Jopie=Jopi
Joplin=yoplin
Jordaan=yordan
Jordache=yordach
Jordan=yordan
Jörgen=yorgen
Jormica=yormica
Josef=llosef
Joseny=yóseny
Josephine=Josephin
Josh=yoch
Joshua=yoshua
Josiah=yosia
Josie=yosi
Joss=yoss
Jossie=yosi
Jötland=Jotland
Journal=yournal
Journal-Constitution=yournal Constitution
Journal-Departamento=yournal-Departamento
Journey=yourny
Jouve=Jouv
Jove=yov
Joy=yoy
Joyce=yuis
Joyner=yoyner
Joys=yoys
JPEG=J PE G
Jr=yunior
Jubal=yubal
Jubilee=Jubile
Jud=yud
Jude=Judé
Judith=lludith
Judkins=Jud kins
Judson=yudson
Judy=yudy
Juicy=yusi
Jukkar=Jukar
Jules=yuls
Julianne=yulian
Julie=yuli
Julienne=llulíen
Juliet=lluliet
Juliette=yuliet
Julius=yulius
July=yuly
JUMBO=llúnbo
JUMBO=llúnbo
JUMBO-JUMBO=llumbo llumbo
Jumper=llumper
Junction=Junctión
June=yun
Jung=yung
Junín=yunín
Junius=yunius
Jurásicoes=yurásicoes
Jurassic=yurasic
Jurgen=yurgen
Jurgenson=llurgénsón
Just=yust
Justica=Jústica
Justice=yústis
Justin=yustin
Justine=yustin
Justineau=llustínau
JVC=JbC
Kabbani=Kabani
Kabburkanakruebemss=Kaburkanakruebems
Kaboom=Kabum
Kade=Kad
Kadeem=Kadem
Kadeer=Kader
Kaelyn=Kaélin
Kaiser=Káiser
Kane=Kein
Kann=Kan
Kanninen=Kaninen
Kannondross=Kanondros
Kannongorff=Kanongorf
Karloff=Karlof
Kasey=Kasy
Kashima=Káchima
Kashmar=Kasmar
Kasidah=Kásida
Kate=keitt
Katelyn=Kátelin
Katharine=Katharín
Kathe=keit
Katherine=Katherín
Katherines=Katherins
Kathie=Kathi
Kathleen=Kat len
Katie=Kati
Katrine=Katrin
Kaye=Kay
Kaylee=Kayli
Kaylie=Kayli
Kayline=Kaylin
Kazz=Kaz
Kazzintuitruaabemss=Kazintuitruabems
K'bunk= bunk
KDPeeps=KD Peps
Kearny=Karny
Kearsarge=Kearsarch
Keaton=Kéton
Keebler=Kebler
Keefe=Kifi
Keeffe=Keffi
Keene=Keni
Keesing=Kesin
Keller=Keler
KELLIE=KELI
Kellogg=Kélog
Kellog's=Kelocs
Kelly=Keli
Kemp=Kenp
Kendall=Kéndall
Kenmore=Kenmur
Kennealy=Kenely
Kennebec=Kenebec
Kennebunk=Kenbunk
Kennebunkport=Ken bunk port
Kennedy=Kénedy
Kennedys=Kénedys
Kenner=Kener
Kennerly=Kenerly
Kenneth=Keneth
Kenniston=Keniston
Kenny=Keny
Kenosha=Kenocha
Kensington=Kensinton
Kentucky=Kentoqui
Kenwood=Kenwud
Kenyon=Ken yon
Kewpie=Kewpai
Key=Khey
KG=K G
KGB=KaGe Be
Khadijah=Kadijah
Kierkegaard=Kierkegard
Kilimanjaro=Kilimanllaro
Killa=Kila
Killian=Kilian
Kilroy=Kilroy
Kimes=Kims
Kinderman=Kinder man
Kingdom=Kíngdom
Kinney=Kiny
Kinsey=Kinsy
Kipper=Kiper
Kippy=Kipy
Kiril=Kril
Kirkwood=Kirkwod
Kirsten=Kirs ten
Kissimmee=Kissmi
Kissinger=Kisinller
KITTEN'S=KITEN'S
Kittery=Kítery
Kittery-Portsmouth=Kitery Ports mouth
Klasenstraat=Klasenstrat
Kleen=Klen
Kleenex=Klinex
Klinger=Klinyer
Klyde=Klyd
Kmart=K mart
Knaach=nach
Knaur=Kanur
knew=niu 
Knight=Kenight
Knightley=Knitley
Knob=Kinob
Knopfler=K nopfler
Knopler=nopler
Knott=Kanott
Knowledge=Knowledg
Knox=quínox
Knoxville=Knoxvill
Kobayashi=Kobaya hchi
Kocernoot=Kocernot
Kodachrome=Kodachrom
Koh-i-noor=Koh-i-nor
Kollege=Kolleg
Kommando=Komando
Kommandos=Komandos
Kool=Kul
Koopman=Kopman
Koppe=Kop
Koppen=Kopen
Körner=Korner
Körners=Korners
Koshien=Kosien
Koyassi=Koyasi
Krakauer=Kraka uer
Kramerbooks=Kramer buks
Krause=Kraus
Krumey=Krumy
Kublai=Kublei
Kugler=Kúgler
Kuiper=Kuper
Kundalpanico=Kunda el pánico
Kunkle=Kunkl
Kushner=Kusner
Kyle=kail
Kylie=Kyli
Kyon=quion
KZ-Apotheker=KaZ- Apotheker
Label=Lebel
Labelle=Label
Lace=Laz
Lacey=Lási
Lacoste=Lacost
Láctea=Lactea
Ladies=leidis
Laehmann=Lihman
Lafayette=Lafayett
l'Afrique=l'Afrik
Lagerführer=Laller fuhrer
Lagerkapo=Laller kapo
Lagerstrasse=Lagers tras
Lakemont=Leikmont
Lakers=Leikers
Lakes=Leiks
Lamar=Lámar
Lamon=Lei mon
Lamotte=Lamott
Lancashire=Lancashir
Lancaster=Láncaster
Lance=Lans
Lancelyn=Láncelin
Lancte=Lanct
Lane=Lein
LANES=LANS
Langhorne=Langhorn
Languedoc=Lánguedoc
Lanie=Láni
LARGE=LARGh
Larribee=Larribi
LaRue=La Rué
Lassburg=Lasburg
Lasses=Lases
Lassie=Lasi
Laszlo=Lazlo
Late=Lat
Lauderdale=Lauderdal
Laughlin=Lauglin
Lauper=Luper
Laurelwood=Laurelwud
Laurence=Laurenz
Laurie=Lauri
Laveau=Lá viu
Lavinia=Lávinia
Lavoie=Lavoi
Lawrence=Lawrens
League=Leag
Leah=Lea
Leakey=Liky
Leale=Leali
Leaning=Lening
Leanne=Lean
Lear=Lair
Learning=Lérning
Leary=Lary
Leather=Leder
Leavenworth=Liven worth
LECHUCERIAScorpius=LECHUCERíA, eScorpius
Lederman=Léderman
Ledger=Ledyer
Lee=lee
Leeds=Leds
Leesburg=Lesburg
Leffing=Lefing
Legacy=Legací
Legend=Leyend
Lehane=Lehan
Leicester=Leic ester
Lelliot=Leliot
Lemberg=Lember
Lemke=Lemk
Lemony=Lémoni
Lengyel=Léngiel
Lenno=Leno
Lennon=Lenon
Lennox=Lénox
Lenny=Leny
Lenore=Lenor
Leone=Leon
Leoni=Léoni
Leopardon=Leopardo
LeSabre=Le Sabre
Leslie=Lesli
Lessing=Lésing
Lestrange=Lestrangchh
Leszczynsky=Leszynsky
Letourneau=Leturneu
Letter=Leder
Letterman=Letermen
Letters=Leders
Lettie=Letti
Levesque=Levesqui
Levi=Livais
Levi's=Livais
Lewiston=Léwiston
Lexie=Lexi
Lexington=Léxing ton
Lhammas=Lamas
Liam=Laiam
Libby=Liby
Libertyville=Libertyvil
Librium=Librum
Lichtenstein=Lichtensten
Liddell=Lidell
Liddy=Lidy
Lies=Lais
Lieshout=Leshout
life=laif
Lifebuoy=Laifbuoy
Lifeson=Lifson
light=lait
Lighthouse=Light jaus
Liiilibeeeth=lilibeth
Liisa=Lisa
like you=laikiu 
Like=laik
Likes=laiks
Lilla=Lila
Lille=Lill
Lilly=Lily
Limestone=Laimston
Lincoln=Lincon
Linda=Línda
Lindberg=Lind berg
Linde=Lind
Lindsay=Lindsey
Lindsey=Lindsy
Lines=lains
Ling-Temco-Vought=Ling Temco Vught
Linneo=Lineo
Lions=laions
Lippy=Lipy
Liquor=Licuor
Liselotte=Liselot
Lisette=Lisett
Litchfield=Litch field
Lite=Lit
Literature=Literatur
Little=lirul
Live=Liv
Lively=Laively
Livermore=Liver mor
Liverpool=Liver pul
Livingstone=Livingston
LIYYYYKE=LaYYYYK
Lizzie=Lisi
Lizzy=Lizy
LME=L M E
Locke=Locki
Lockheed=Lockjed
Lodge=Lodch
Loggins=Lojins
Loghu=Logu
LOGIN=LOllIN
Lohan=Lojan
Lonesome=Lonsom
Longbottom=Longbotom
Longfellow=Longfelow
Longinus=Longinús
Longley=Longly
Longstreet=Longstrit
Looking=Lukin
Lookout=Lok aut
Loom=Lum
Loonybin=Lonybin
Loops=Lups
Lophiiformes=Lofiformes
Lorrington=Lorinton
los Quagmire=lohs Quagmir
Lottie=Lotti
Louboutin=Lou botin
Louboutins=Luboutins
Louella=Louela
Louis=Lo uis
Louisa=Lúisa
Louise=Louis
Louisiana=Luisiana
Louis-le-Grand=Lois le Grand
LOUISON=LoUISòN
Louisville=Louisvill
Lounge=Loung
love=lov 
Löwenbach=Lowen bach
Löwenbräu=Louen brau
Lowman=Luman
LSD=eLeeSe De
Lucile=Lucil
Lucille=Lucill
Lucite=Lucit
Lucozade=Lucozad
Lucrèce=Lucréz
Lucy=Lusy
Ludlow=Lud low
Luftlagemeldung=Luft lagemel dung
Luger=Luguer
Lugers=Luguers
Lujza=Lucza
Luke=Luk
Lullus=Lulus
Lulu=Lulú
Lululu=Lu lu lu
Lumley=Lumly
Lummi=Lumi
Lüneburg=Lunburg
Luneville=Lunvill
Lunney's=Lunys
Lurie=Luri
Lussier=Lusier
Luykenstraat=Luykenstrat
Lycoming=Lai comin
Lyme=Lym
Lyn=Lin
Lynch=Linsch
Lynette=Lynet
Lynn=Lyn
Lynnwood=Lyngud
Lyon=Laion
Lyonos=Lionos
Lyons=laions
Lysol=Láisol
Mª=Mariá
Maaren=Maren
Maarsen=Marsen
Macallan=Macalan
Macassi=Macási
MacBook=Mac Buk
MacCool=MaCul
MacDonald=Mac Donald
MacDonaldland=MacDonald land
MacGraw=MaGraw
Machias=Machis
Machina=Machin
Machine=Machin
Machines=Machíns
MacKenzie=MacKenzi
MacLean=Mac Lean
MacLeish=Mac Leish
Macon=Meicon
Macy=Masi
Macys=Ma sys
Madame=Madam
Mädchen=Madchen
Madder=Mader
Maddie=Madi
Maddock=Mádock
Maddox=Madox
Maddy=Mady
MADE=meíd
Madeleine=Madelein
Madge=Madc
Madingley=Madingly
Madison=Mádison
Madonna=Madona
Madrone=Madron
Maelstrom=Melstrom
Mafoy=Malfoy
Magazine=Mágazin
Maggie=Magui
Maggio=Magio
Magic=Mállic
Magnum=Mágnum
Magnusson=Mag nuson
Magritte=Magritt
Maguire=Macguair
Mahal=Majal
Maharishi=Maharichi
Mahy=May
Maiden=Meiden
Mailboxes=Mail boxs
Maine=Mein
Mainlining=Mainling
Maintenant=Meintenant
Majestic=Malléstic
Major=Mayor
Maker's=Meiker's
Making=Méiking
Maladies=Maladis
Malcom=Málcom
MalditoMINISTERIO=Maldito MINISTERIO
Malebolge=Malbolch
Ma-lee=Mali
Malladonny=Maladony
Mallionaires=Malionares
Mallory=Mállory
Malone=Malon
Maloney=Málony
Mamadou=Mama dou
Mamma=Mama
Mammy=Mamy
Management=Manayement
Manchester=Mánchester
Manderley=Manderly
Mandeville=Mandevil
Manganelli=Manganeli
Manger=Manyer
Manny=Many
Manson=Mensón
Mantle=Mantl
Many times=Meni taims 
Mapleline=Maplelin
Marbella=Mar bella
Marble=Marbl
Marcello=Marcelo
Marcellus=Marcelus
Marcy=Marsy
Margaret=Márgaret
Margaritaville=Margaritavill
Marge=March
Margery=Márllery
Margie=Marlli
Margje=March
Margo=Margod
Margrave=Margravi
Marian=Marián
Marianne=Marián
Maricelli=Mariceli
Marie=Mari
Marilyn=Márilyn
Mariole=Mariol
Marjorie=Marlluhrí
Markstone=Markston
Marlborough=Marlboro
Marle=Marli
Marley=Marly
Marmaduke=Marmaduk
Maroon=Marun
Marple=Márpul
Marsella=Mársella
Marsh=March
Marsha=Marcha
Marshall=Márchall
MARTAINE=MARTAíN
Martin=Mártin
Martineau=Mártineu
Martin-Gale=Martin Gueil
Marveller=Márvelér
Maryland=Mery land
Marylebone=Marylebon
Masamune=Masamún
Mase=Meis
Masrani=Mashrani
Massey=Masi
Massy=Masy
Masterpiece=Masterpis
Masterton=Másterton
Matchstick=Match stick
Mathean=Mátian
Mathematical=Máthematical
Mathers=Maders
Mathew=Mathiw
Matias=Matías
Matisse=Matis
Matteu=Mattiu
Matthew=Matthiw
Matthias=Matías
Matthieu=Matthiu
Maureen=Mauren
Maurice=Mauriz
Mavjee=Mavji
Maxfield=Maxfild
MaxHeadroom=Maxjedrum
Maxi-Duty=Maxi Duty
Maxine=Maxin
Maxwell=Maxwel
Maybe=Mei-be 
Mayberry=Mey bery
Maybone=Meybun
Maybrook=Maybruk
Mayfair=Mayfir
Mayle=Mayl
Mayr=Meyr
Maytags=Maytacs
Maze=Maz
Mazinger=Mazinyer
Mazinger-Z=Mállinger Z
Mazzini=Mazini
MCA=M C A
McAvoy=MAc voy
McBee=Mac Bi
McCall=MaCall
McCann=MacCan
McCarron=MaCarron
McCarthy=MaCarty
McCartney=Mac Courni
McCaskell=MaCaskel
McCasland=Macasland
McCausland=Ma Causland
McCheese=Ma Chis
McClannahan=MaClanan
McClellan=MacClillan
McClelland=Ma Cleland
McClintock=MaClintóck
McClub=Mac Club
McClure=MacClur
McClurg=MaClurg
McConaughy=Mac Conaugh
McCone=Ma Coni
McConnell=Ma Cónal
McCowan=MaCouan
McCoy=MacCoy
McCracken=MaCracken
McCraken=Ma Craken
McCullogh=MacCullogh
McCullough=MacColouk
McCune=MaCune
McCurdy=MaCurdy
McCutcheon=Ma Cutchen
McD=Mac D
McDermott=Mac Dermott
McDonough=MacDonouh
McDowell=Mac Dowell
McElroy=MacElroy
McGee=Mac Gi
McGhee=MaGhi
McGilligot=MacGuiligot
McGinn=MacGinn
McGonagal=MacGonagal
McGonagall=MacGonagall
McGonagll=MacGonagal
McGonigal=MaGonigal
McGoohan=Mac Gojan
McGovern=Mac Govern
McGowan=MacGowan
McGown=Mac Gown
McGrath=MacGrath
McGruff=MaGruff
McGuffin=MacGufin
McGuire=MacGuair
McHanrahan=Mac janran
McInerney=Mac lerny
McInnes=MacInes
McIver=Mac Iver
McKean=MacKin
McKeen=MaKuin
McKem=MaKem
McKenn=MaKen
McKenzie=MacKenzi
McKenzies=MacKenzis
McKinley=MaKinley
McKinney=MacKiny
McLain=Macláin
McLaine=Mac Lain
McLaughlin=MacLaughlin
McLeay=MacLay
McLeod's=Mac Leod's
McMahon=Mac Mahon
McMann=Mac Man
McMansión=Mac Mansión
McManus=MacManus
McMuffin=Mac Maffin
McMuffins=Mac Muffins
McMurdo=Mac Murdo
McMurtry=Mac Murty
McNally=Ma Naly
McNamara=Mac Namara
McNaughton=MacNauton
McNeil=MacNeil
McNugget=Mac Nuguet
McQuay=Mac Quay
McTeague=MacTeag
McTighe=MacTighe
McYeats=MaYeats
me da la impresión=me da la impresióhn
Mead=Med
Meadows=Mea douns
Meal=Mel
mean=miin 
Mearton=Merton
Meat=Met
Mechagodzilla=Mecagodzila
MeCutcheon=MeCutchen
Medicare=Mediqueir
Medicine=Medicin
Mediterranean=Mediterranian
MedLine=MedLin
MedWeb=Med guheb
Meeker=Méker
Megadon=Megadón
Meggs=Mecs
Megs=Meks
Melanie=Mélani
Melbourne=Melbourn
Mellancamp=Melan camp
Mellencamp=Melencamp
Melly=Mely
Melody=Mélody
Melrose=Melros
Melville=Melvill
Mendelssohn=Méndelsón
Mengele=Mengel
Mercalli=Mercali
Mercury=Mércury
Mercy=Mersi
Meriwether=Meriwither
Merlin=Merlín
Merriman=Merimán
Merrin=Merin
Merrow=Mirrow
Merrywether=Merywither
Mesanges=Mésanlles
Messenger=Mésinyer
Messieurs=Mesius
Messitte=Messitt
Metalious=Metalus
Metallica=Métalica
Metallus=Metalus
MGM=emyi éM
MHW=MH dole u
Mia=Mía
Miata=Míata
Michael=máicol
Michaels=Maichels
Michelin=Michelín
Michelle=Michel
MICHETTE=MICHET
Michigan=Michigán
Michonne=Michon
Mick=Maick
Mickey=Micky
Microbiology=Microbioloyi
Middle=Midl
Middleton=Middlton
Middletown=Middltaun
Midway=Midwey
M-I-E-R-D-A=mierda
Mihalkov=Mijalkov
Mikey=Miky
Mile=Mil
Miles=mils
Miley=Máili
Milhone=Milhon
Milland=Miland
Mille=Mill
Millenium=Mileniun
Miller=Miler
Millhouse=Mill house
Milligan=Miligan
Milliken=Miliken
Milliner=Miliner
Millinocket=Mílinoket
Mills=Mils
Milwaukee=Milwauki
Mimms=Mims
Mindanao=Mindanau
mini-DV=mini-Db
Minie=Mini
mini-Gatling=min-Gatling
Minishort=Minichort
Minishorts=Mini chorts
Minna=Mina
Minneapolis=Míneapolis
Minnesota=Minezota
Minnie=Mini
Miracles=Miracls
Mirage=Mirach
Miraqueestoyalapuertayllamo=Mhira que estoy a la puerta y llamo
Mirassou=Mirasu
Mirecourt=Mircurt
Mireille=Míreihl
Miriam=Miriám
Mirianishvili=Mirianishvil
Miserville=Miservil
Misha=Micha
Mishima=Michimá
Miss=Mis
Mission=Míson
Mississippi=Mississipi
Mississippi-Missouri=Misisipi-Misuri
Mississippis=Mississipis
Missoula=Misoula
Missouri=Missuri
Missouri-Mississippi=Misuri-Misisipi
Missy=Misy
Missymona=Misy mona
Mitch=Migch
Mjolnur=Mayolnur
Mkebe=Makeb
MlKE=MaiK
Mm=em
Mmm=humm
Mmmm=hummm
M-M-M-Melanie=eM eM eM Melani
Mobile=Mobil
Moët=Moet
Moffie=Mofi
Mohamed=Mojaméd
Mohammed=Mojamed
Molahonkey=Molajonky
Moldow=Móldow
Moleskine=Molskin
Molie=Moli
Molliare=Moliar
Molly=Moly
Monaco=Mónaco
Mondale=Mondal
Monday=Mondey
Monhegan=Monegan
Monkey=Monky
Monkey's=Monkis
Monnie=Moni
Monopoly=Mónopoli
Monroe=Monrróe
Monterey=Monte rey
Montgomery=Mongómery
Montpellier=Mont pellier
Montrose=Montros
Moochie=Mochi
Mood=Mud
Moody=Mody
Moon=Mun
Mooney=Mony
Moor=Mur
Moorer=Morer
Moores=Murs
Moortje=Murt
Moosehead=Musjed
Moosuntic=Mosuntic
Mordecai=Mordecái
more=mor
Morey=Mory
Morgantown=Morgan taun
Morgenstein=Morguenstein
Morlake=Morlak
Morning=Mornin
Morrehouse=Morr jaus
Morrison=Morison
Morrow=Murrow
Morrow-san=Morru-san
Mortmain=Mortmáin
Mortonson=Mortonsón
Motley=Motly
Motrin=Motrín
Moulton=Multon
Mount=Munt
Mountain=Moún tain
Mountjoy=Mountyoy
Mountlake=Muntlak
Mouschi=Muschi
Mouskouri=Mouskuri
Mozart=Mózart
MP=emepe
Mr=Mister 
Mrs=Misis 
MTA=M T A
MTAC=Muñeca Táctil Anatómicamente Correcta
MTV=emti bi
much=mach 
Mudskipper=Mudskiper
Mueller=Mueler
Muggs=Mugs
Muhammad=Mujamad
Muhlen=Mulen
Mukherjee=Mukerji
Müller=Müler
Mullins=Mulins
Munch=Munc
Munich=Miunich
Múnich=Múnihch
Munsey=Munsy
Murphy=Murfy
Murrow=Murow
Muscle=Muscl
Museam=Musem
MUSICA=MúSICA
Musketeers=Musketers
Muskie=Muski
Mussolini=Músolini
Mustang=Mústang
MX=eMe X
Mycelium=Micélium
Myers=Mayers
Myers's=Máiers
Myra=Maira
Myrtle=Myrtl
Myserville=Maiservil
N º.=número
N º=número
n.º=número
Naa-naa-naa-naana-na-na=Naa naa naa na na na
Naazi=Nazi
Nacogdoches=Nacog dochs
Nadège=Nadèch
Na-Dene=Na-Den
Naggini=Naguini
Nancy=Nánsi
Nanette=Nanet
Napoli=Nápoli
Nash=Nach
Nashville=Nashvil
Natalie=Nátali
Natalucci=Nataluci
Natasha=Natacha
Natcher=Nat cher
Nate=Nat
National=Nachonal
Nature=Nachur
Naugle=Naugl
Navigator=Navigueítor
NBA=enebea
NBC=N B C
NDI=ND I
Neadeau=Neadeu
Nebula=Nébula
Necrosum=Nécrosum
Needles=Nidles
negligencia=neglijencia
Negroes=Ni gros
Nella=Nela
Nellie=Nelli
Nelly=Nely
Neonoir=Neo noir
Neosporin=Neos porín
Nerdfighters=Nerd fighters
Nerezza=Nereza
Netrebko=Netreko
Neuengamme=Neuengam
Neuilly=Neuily
Neumann=Niuman
Neurolingüística=Neuro lingüística
Never=Never
Neville=Nevill
New=Niw
Newark=Niwark
Newbury=Niwbury
Newcombe=Niucomb
New-combe=Niw-comb
Newington=Newinton
Newman=Niuman
Newport=Niuport
Newsweek=Niws wik
Newt=Niut
Newton=Niuton
Ngo=eNgou
Nguyen=eNguyen
Nicco=Nico
Nicholas=Nicolas
Nichole=Nicol
Nichols=Nicols
Nickolls=Nicols
Nicolas=Nícolas
Nicolay=Nicoláy
Niece=Nies
Nielson=Nilson
Niesten=Nisten
night=nait
Nightingale=Nightingal
Nightline=Nightlin
Nikes=naiks
Nimrod=Nirod
Nine=Nain
Nínive=Níni ve
Ninja=Ninya
Nipper=Niper
Nite=Nit
Nivernaise=Nivernais
Nnnnnnnnnnn=enn
Nº.=número
Nº=número
nº=número
Noah=Noa
Nocturnal=Nócturnal
Noémie=Noémi
Noor=Nur
Nooz=Noz
Norah=Nora
Nordhoff=Nordof
Norge=Norch
Normie=Nórmí
Norrath=Norath
Norseman=Norse man
Northcore=Northcor
Northcote=Northcot
Northeast=North est
Northern=Norten
Northerners=Nort herners
Northside=Northsid
Northwoods=Northwuds
not=nat 
Nothing=No zing. 
Notting=Nading
Novite=Novit
Novosibirsk=Novo sibirk
Now=Naw
NRA=N eRe A
NSA=N S A
Nuget=Núguet
Nugget=Nuguet
Nunnally=Nunaly
Nutella=Nutéla
Oahu=O ahu
Oase=Oas
Obama-Hillary=Obama-jilary
Oberscharführer=Obers char fúrer
Obersturmbannführer=Obersturm ban furer
Obscure=Obscur
O'Casey=O'Casi
Ocean=Ohucean
O'Connor=O'Conor
Oculance=Oculans
Odinware=Odinwar
O'Donnell=O Dónel
of=af
OFF=OF
Offee=Offi
Ogilvie=Ogilvi
Ogroroland=Ogroro land
Oh=Oh
Ohio=Ojaio
Oil=O il
Ôini=oíni
OK=Oquei
Oklahoma=Oklajóma
O-L=O L
Oldenburg=Oldenbur
Oldsmobile=Olds mobil
Olli=Oli
Ollie=Oli
O'Lunney's=O'Lunys
Omaha=óhmaja
Omnictionary=Omnic tionary
O'Neil=O'Nil
O'Neill=O'Nill
ONG=oene ge
only=Ounly
Ontello=Ontelo
Ontologically=Ontologicaly
Oompa-Loompa=ompa-Lumpa
Oops=ups
Oosler=Osler
Oosthuizen=Osthuizen
Ophiocordyceps=Ofio cordiceps
Opium=ópium
Oppenheimer=Openjeimer
Oprah=Opra
Orange=Oransch
Oranjee=oranhgch
Orbison=órbison
Orc=Orch
Ordway=Ordwey
Orense=Orens
Oreo=óreo
Oriana=Orihana
Orleans=órle ans
Orrington=orrintón
Orsay=or sai
Orvie=Orvi
Orville=Orvill
Osaka=ósaka
Osborne=Osborn
OSHA=OcHA
Oshkosh=Oskocsh
Osmehel=ósmehel
Osprey=Ospry
OSWALDŚ=óSWALDŚ
Ottaline=otálin
Ottawa=Otawa
Ötzi=otzi
Ouija=uija
our=aor 
out=aut
Overhill=Overjill
Overlock=Overluck
Overlook=óverlok
Overway=Overwey
OVNI=obni
Oxford=oxfórd
Oxigeno=Oxígeno
Oxley=Oxly
Ozz=Oz
Ozzeman=Ozman
P.D.=postdata
Paar=Par
Pabodie=Pabodi
pace=peis 
Packardsville=Packardsvil
Packar-Takens=Packar-Teikens
Paddy=Pady
Pagliazzi=Pagliazi
Paige=Peich
pain=páin
Paine=Pein
Palmdale=Palmdal
Palpatine=Palpatin
Paltryville=Paltrai vil
Panasonic=Panasónic
Pancakes=Pankeiks
Pandemonium=Pandemónium
P-A-N-T-H-E-R-A-L-E-O=PANTERA LEO
Papanicolau=Papa nicolau
Paper=peipers
paradise=parodaes 
Paramore=Paramor
Parasite=Parasit
Parfumeur=Parfumur
Parker=Párker
Parkette=Parkett
Parkway=Parkwey
Parliament=Parlament
Parmeleau=Parmeleu
Parsons=Pársons
Party=Pary
Parvati=Parváti
PARZIVAL=PársiváL
Parzival-san=Párzival-san
Pascow=Pascóu
Paskow=Pasków
Passadumkeag=Pasadumkeg
Passmore=Pasmur
P-A-S-T-I-L-L-A-S-D-E-M-E-N-T-A=PASTILLAS DE MENTA
Patrnus=Patronus
Patrone=Patron
Patronum=Patrónum
Patterns=Paterns
PATTI=PATI
Patty=Paty
Paulie=Pauli
Pauline=Paulin
Pause=Paus
Pawnee=Pawni
PayDay=PeyDey
Pazuzu=Pazuzú
PDA=P D A
Peace=piz
Peach=Pech
Peaches=Piches
Peachtree=Peschtri
Peak=Péek
Peal=Pel
Pearly=Perly
Pearson=Pirson
Pease=Piss
Pebbles=Pebles
Pedersen=Pédersen
Peeta=Peta
Pegaso=Pegazo
Pegs=Pecs
Pelee=Pelée
Pelham=Peljam
Pellaeon=Pelaeon
Penchsley=Penschsly
Pendragon=Pendragón
Penisville=Penisvill
Penn=Pen
Pennsylvania=Pensylvania
Penny=Peny
Pennywise=Penywis
Pennzoil=Penzoil
Penthouse=Pen jaus
Pepitone=Pepiton
Pepper=Peper
Pepperidge=Peperid
Pequod=Pequd
Percy=Persy
Percy'había=Perci había
Perey=Pery
Pérignon=Périg ñon
Perlmutter=Pérmuter
Perreault=Perrault
Pershing=Pirshing
Pescelli=Peceli
Pete=Pit
Petel=Pítel
Peter=Piter
Peters=Piters
Peterson=Piterson
Petey=Píhti
Petrie=Petri
Petronella=Petronela
Pettibone=Petti bon
Pettingill=Petinjill
Pevees=Pevées
Pew=Piw
Pfeffer=Pfefer
Pfeiffer=Pfifer
pfff=puff
Pfizer=Pficher
PGE=P G E
Phalanxifor=falansifor
Pharmaton=Pharmatón
Phat=Pat
Pheure=Pheur
Phileas=Fíleas
Philippe=filipe
Philippine=Philipin
Phillip=fhilip
Phillips=filips
PHIPPS=PHIPS
PHOENIX=PHENIX
Phoenix-Salt=fenix-Salt
Photoplay=Photopley
Photoshop=Photochop
Phsy=fisy
PHUPA=PUPA
Phyllis=filis
Picadilly=Picadily
Piccadilly=Piccadily
Picture=pik chur
Pictures=Pichurs
Pieceford=Pisford
Pieces=Pices
Pierce=persi
Pierdelandia=Pierde landia
Piernilargo=Pierni largo
Pierre-Jean=Pierr yean
Pieter=Piter
Pigeon=Pigueon
Piggy=Pigy
PIII=Pii
PIIIIIP=PI II IIP
PIIIP=PI IIP
pijama=pillama
Pike=Pik
Pilcher=Pílcher
Pilot=Páilot
Pilsner=Pilner
Pimm=Pim
Pimplebottom=Pimpl butom
Pine=Pini
Pinecone=Paincon
Pinéde=Pinéd
Pineland=Pain land
Pines=Pins
Pinewood=Painwud
Piney=Piny
Pinkerton=Pinker tón
Pioneer=Paioner
Pipeline=Pipelin
Pippi=Pipi
Pirates=Pirats
Pitcairn=Pit cairn
Pitch-Til-U-Win=Pitch TilU Win
Pitibibe=Pitibib
Pittsburgh=Pitts burh
Pittsfield=Pitsfild
Pittston=Pitston
Pixie=Pixi
Pizza=Picza
Pizzería=Piccería
Pjotr=Pijor
Place=Pleis
Plague=pleich
Plains=Pleins
Planche-du-Rempart=Plang -du-Rempart
Platte=Platt
Player=pleyer
Player-versus-Player=Player vérsus Player
Playskool=Pleys kul
PlayStation=PleyStechon
Playtex=Pleytex
Pleasance=Plasanz
Pleasant=Plesant
Pleasantview=Plasant view
Pleasantville=Plasant vil
Please=Plis 
Pleasent=Plesent
Pleasuredome=Plesur dom
Plessis=Plesis
Plessy=Plesy
Plough=Plou
Plymouth=Pley mounth
PM.=pm
PM=pm
Pnakóticos=nakóticos
PNJ=Personajes no jugadores
PNL=Programación Neuro Linguhística
Poe=Póe
Poincaré=Poincar
Poke=Pok
Polecat=Polcat
Police=Pólis
Policy=Pólisy
Polizei=Polizi
Polly=Poly
Pollyanna=Poliana
Pompadour=Pompadur
Ponch=Ponsch
Pondicherry=Pondichery
Pontcarré=Pont carré
Pontchartrain=Pontchartrein
Pontiac=Póntiac
Pooh=pu
Pookie=Poki
Pope=Pop
Poppy=Popy
Porsche=Porch
Porthole=Port jol
Portlana=Port lana
Portland-Westbrook=Portland-Westbruk
Portsmouth=Ports muth
Portugues=Portugués
Positron=Positrón
Possession=Posesion
post-Christian=post Christian
Post-Gazette=Post-Gazet
Poteenville=Potenvill
Potomac=fótomac
Poughkeepsie=Poughkipsi
Pouilly=Pouly
Pourciau=Porzu
Poverelli=Povereli
Powell=Pówell
Praagh=Pragh
Praag-Sigaar=Prag-Sigar
Prattes=Pratts
Preakness=Prekness
pre-Colapso=preColapso
Predator=Pre deitor
pre-Halloween=pre-jáloguhen
pre-Hogwarts=pre. -jaguarts
pre-Jeremy=pre-yeremy
Premium=Prémium
Presd=Prest
Presley=Prés li
Press=Pres
Press-Herald=Press jerald
Prêt=Pret
Pretty=Prety
Pricetown=praistun
Pride=Prid
Primaria=Primariá
Prince=Prains
Princeton=Prain ceton
Principles=Prainciplis
Prinsengracht=Práinsengrat
Private=Privat
Professor=Profesor
Prokofiev=Prokofiv
Providence=Providenz
PROVINCE=PROVINs
Provincetown=Provinztawn
Prudhomme=Prudhom
Prudie=Prudi
Prufrock=Prúfroc
PS.=postdata
PSA=P S A
PSP=píespí
PSYCHLONE=SYCLON
Psycho=syco
Psyshic=pyshic
Publishers=Publichehrs
Publishing=Publicing
Puffer=Pufer
Puget=Puguet
Puppy=Pupy
Purdue=Purdui
Purinton=Púrinton
Purple=Purpl
PvP=Jugador vérsus jugador
PVS=pebeese
Pyramid=Pairamid
Pyrex=Páirex
Python=Pitón
QCE=Q CE
QUABBIN=QUABIN
Quagmire=Quagmir
Quake=Quaki
QualityEbook=QualitEbuk
Queems=Qúhins
Queequeg=Qué quég
Quentin=quhentin
Quentín=Quhentín
Quest=Quhits
Quigley=Quigly
Quillan=Quilan
Quinceberry=Quinsbery
Quincy=Quinsy
Quinn=Quin
Raah=Rá
Raaku-tu=Raku-tu
Rabbi=Rabí
Rabbit=Rabit
Raccoon=Racón
Rachel=réichel
Rachele=Rachel
Rachelle=Rachel
Racine=Racin
Racing=Reicing
Racoon=Réicon
Rafferty=Raférti
Rage=Rag
Rags=Racs
Raideen=Raiden
Railroad=Reilrod
Railway=Reilwey
Rainbow=Reinbow
Raines=Rains
Rainier=Reiner
Rains=Reins
Raintree=Reintri
Raise=Rais
Ralph=Ralff
Ralstoi-Purina=Ralstoi Purina
Rambler-Supreme=Rambler-Suprim
Ramone=Ramon
Randall=Rándal
Randolph=Rándolph
Random=Rándom
Range=Renhch
Rangeley=Rangely
Rangely=Rangel
Rangers=rén yers
Rapeloew=Rapelow
RAPPAHANNOCK=RAPANOCK
Rapport=Rap port
Rapportschreiber=Raports chreiber
Raquel=Rakel
Rassenschande=Rasenschand
Rathbone=Rathbon
Raul=Raúl
Ravensbruck=Reivens bruck
Ray=Rey
Ray-Ban=Rey-Ban
Ray-Bans=Rey-Bans
Rayburn=Rey born
Raymond=Reymond
Razberry=Razbery
RCA=R C A
RDA=R D A
Reach=Rich
Reade=Read
Reader's=Rider's
Readfield=Redfild
Ready=Redy
Reagan=Rigan
Reamer=Rimer
Reaper=Riper
Rebecca=Rebeca
Reckoners=Rec honrs
Reconnaissance=Reconaissan
Redde=Redd
Redding=Réding
Red-Eye=Red ai
Redstone=Redston
Redwall=Redwell
Redwing=Reduing
Reece=Reci
Reed=Rid
Reef=Rif
Reekie=Riki
Reelfoot=Rilfut
Reena=Rina
Reenie=Reni
Reese=Rais
Reese's=Rese's
Regal=Ri gal
Regan=Rigan
Regency=Regensy
Reggie=Regi
Regís=Reyís
Reichsmarschal=Reichs mars chal
Reliance=Relianss
Remmy=Remy
Remora=Rémora
Rendleton=Redlentón
Rene=René
Renfrew=Renfriw
Rennert=Renert
Rennet=Renet
Renny=Reny
Renshaw=Renchaw
Rent-A-Wreck=Rent-A-greck
Repair=Reper
Reptivite=Reptivit
Rescue=Resquiu
Résidence=Résidens
Resistance=Resistanz
Resort=Risort
Resurrection=Resurechón
Revelstoke=Revelstok
Revenge=Revengch
Revolution=Revoluchon
Rhian=Raian
Rhine=Rhin
Rhinebeck=Rhinbeck
Rhode=Rod
Rhonda=Ronda
Ribbonmaker=Ribon méiker
Rice=Raiz
Richards=Richardds
Richforth=Rischforth
Richie=Richi
Richter=Ríhchsshter
Richwood=Richjuud
Ridden=Riden
Ridder's=Rider's
Riddle=Ridli
Ride=Raid
Riders=Raiders
Ridge=Ridye
Ridgeway=Ridllewey
Riggins=Riyins
Rig-Veda=Rig-Ved
Rijksmuseum=Riks museum
Riley=Raili
Ring-Ding=Ring Ding
Ringer=Rinller
Ringgold=Ringold
Rinkenhauer=Rinken jauer
RIOD=RíOD
Ripper=Riper
Ripple=Ripl
Riptide=Riptid
Ritchie=Ritchi
River=Raiver
Rivers=Raivers
Riverside=Raiversid
Riverworld=Raiverworld
Rizzo=Rizo
Roach=Roch
Roachclip=Rogcclip
Roadmaster=Rod master
Roadmasters=Rodmasters
Roadrunner=Rod runer
Roanoke=Roanok
Robber=Rober
Robbie=Robi
Robbin=Robin
Robby=Roby
Robeson=Robson
Robideau=Robideu
Robinette=Robinett
Robinson=Robin son
Robinson-Smythe=Robinson-Smyth
Robison=Róbison
Robotron=Robotrón
Rocco=Roco
Rochelle=Rochel
Rockaway=Rock awey
Rockefeller=Rockefeler
Rockville=Rockvill
Rockwell=Rockguhell
Rockwood=Rock wud
Rocky=Roqui
Rocy=Rosi
Rodney=Rodny
Rodny=Rotny
Roebuck=Robuck
Roethke=Roethk
Rogers=Royers
Rolemaster=Rolmaster
Rolfe=Rolf
Rolland=Rollan
Rolling=Rolin
Rollings=Rolings
Rollins=Rolins
Rolls=Rols
Rolls-Royce=Rols Royz
Rolls-Royces=Roll Roys
Roma=Romá
Romane=Roman
Rome=Rom
Ronnick=Ronick
Ronnie=Roni
Roof=Ruf
ROOM=RuM
Roosa=Rosa
Roosevelt=Rusvelt
Roosevetl=Rusvel
Roper=Ruper
Ropes=Rops
R-O-Q-U-É=eRre, O, QUu, e
Rosacruces=Rosacruz
Rosalie=Rósali
Rosalynn=Rosalín
Rosanne=Rosán
Roscoe=Roscò
Rose=roús
Roseberry=Rosbery
Rosellen=Roselén
Rosemont=Rusmont
Roses=Róuses
ROSETTE=ROSET
Rosewood=Roswud
Rosianna=Rosiana
Rosie=Rosí
Rosselli=Roseli
Rossington=Rosinton
Rossiter=Rositer
Rosslyn=Ross lyn
Rossmi=Rosmi
Rosso=Roso
Rottenmund=Rotnmund
Rouge=Roug
Roule=Roul
Rounds=Raunds
Rowle=Rowl
Royal=Róllal
Royce=Royz
Rozsa=Roza
Ruach=Rach
Rubble=Ruble
Rube=Rub
Rubeus=Rubius
Ruby=Rubí
Rucklehouse=Ruckl jaus
Rudiger=Rudijer
Rue=Rúe
RUN=R U N
Runaround=Run around
Runner=Runer
Running=Runin
Ruopp=Ruop
RU-Pentium=RU Péntium
Rusell=Rúsell
Rush=Ruch
Rushdie=Rushdi
Rushing=Ruchinc
Russe=Russ
Ruthie=Ruthi
Rutledge=Rutledch
Ryan=Raihan
Ryder=Raider
Rye=Rie
Ryoko=riokuo
Saab=Sab
Saabs=Sabs
Sabbatus=Sabatus
Sabine=Sabin
Saclanges=Sacláncs
Sadie=Sadi
Saf-T=SafT
Saine=Sain
SAINTE=SAINT
Saint-Elme=Saint-Elm
Saint-Giraud=Saint-lliraud
Saint-Honoré=Saint-Honóre
Sakey=Saky
Salay=Saly
Salem=Sálem
Salinger=Salinyer
Sally=Saly
Salomon=Salomón
SAMAA=SAMA
Sammi=Sami
Sammy=Samy
Sammy's=Samys
Sample=Sampl
Samsonite=Samsonit
Sanatorium=Sanatórium
Sanazzaro=Sánasaro
Sandburg=Sand burg
sandwich=sánduich
Sangamon=Sanga mun
Sanger=Sanller
Sanjit=Sanllit
Sanne=San
São=Sao
Sapphire=Sapphir
Sarah=Sara
Sarge=Sarg
Saruman=Sarumán
Sasha=Sacha
satellites=satlelaits 
Saturday=Sadur dey
Saul=Saúl
SAUVAGE=SAUVAch
Savage=Savach
Savannah=Savana
Save=seiv
Savile=Savil
Saville=Savill
Savings=Savins
Savior=Seivior
Sawdust=Sowdust
Saxe=Saxi
Sayn-Wittgenstein=Sayn Witgenstein
Scarborough=Scarborogh
Scarne=Scarn
Scarra=Scara
Scarramanger=Scaramanger
Schaap=chap
Schafer=Schifer
Scheepsma=Schepsma
Scheipe=Scheip
Scheisskommando=Scheis komando
Scheiss-Stucke=Scheiss-Stuck
Scheppel=chepel
Schering=eScherin
Schiller=chiler
Schlossinger=closinguér
Scholastic=Scolastic
Scholes=Sculs
Scholl=Scull
Schoolhouse=Scul jaus
Schoondist=chóndis
Schooner=Schuner
Schreibstube=chreibstub
Schrödinger=eschrodinguer
schschsch=chis chis chis
Schubert=chubert
Schumacher=chumajer
Schumann=chuman
Schuster=chuster
Schutzhaftling=Schutz jafling
Schuyler=chuyler
Schuylkill=eSchuylkill
Schwartz=Schguartz
Schwarz=eSchuarz
Schweppes=Swepes
Schwinn=chwinn
Scofield=Scofild
Scollay=Scoly
Scooby=Scuby
Scooby-Doo=Scuby-Du
Scooby-Doos=Scuby Dus
Scorpius/Harry:=eScorpius jarry
-Scorpius/Harry=-Scorpius jarry
—Scorpius/Harry=—Scorpius jarry
Scottie=Scotti
Scotty=eScoty
Scouts=Scauts
Scrabble=Scrabull
Scrooge=Scrug
Scully=Sculy
Seadrift=Siadrift
Seagram=eSgram
Seahawk=Siahawk
SEAKING=Si KING
Sears=Siars
Sea-Tac=Si-Tac
Seatle=Searul
Seattle=séarull
Seattle-Tacoma=Séarul Tacoma
Second=Sé cond
Secret=Sicret
See you later=Si iu leiter
See=Si
see=sii 
Seewoosagur=Siwo sagur
Seger=Seguer
Seidle=Seidl
Seigneur=Seignur
Selene=Seléne
Selfridges=Selfrids
Sellers=Selers
Seminole=Seminol
Senanges=Senangcs
Sénanges=Sénangcs
Senate=Senet
Serpentine=Serpentin
Services=Servis
Sesame=Sesam
Seuss=Seus
SEVC-d=SEV C-d
Seventeen=Seventin
Seward=Si ward
Seymore=Seymor
SFFWorld=SF Word
SFSite=SF Sit
Sh=eS
Shabene=chaben
Shack=chack
Shackleton=Shack leton
Shades=cheids
Shah=chah
Shake=cheik
Shake'n=cheiken
Shakespeare=chéspier
Shakin's=chakin's
Shalott=chalott
Shamu=chamu
Shandy=chandy
Shannon=chanon
Shape=cheip
Shapiro=chapiro
Shar=char
Sharif=charif
Sharkko=charko
Sharla=chárla
Sharon=charon
Sharp=charp
Sharpie=charpi
Sharpsburg=charsbur
Sharp-Twinkles=charp-Twinkls
Sharp'y=charp'y
Shasta=chasta
Shave=chav
Shaver=Seiver
Shavers=chavers
Shawbeck=chaubeck
Shawn=chawn
Shawshank=chawsank
Shay=chay
She=chhi
Sheb=cheb
Shedd's=ched's
Sheedy=cheedy
Sheena=china
Sheepcote=Sepcot
Sheepscot=chepscot
Sheerson=cherson
Shefford=cheford
Sheila=cheila
Sheindinks=cheindinks
Shelby=chelby
Shell=chell
Shelley=chely
Shelton=chelton
Shenandoah=chenandoa
Shepard=chepard
Sheperd=cheperd
Shepherd=cheper
Shepley=chipley
Sheppard=chépard
Sher=cher
She-Ra=che-Ra
Sheraton=cheraton
Sherburne=cherbúrn
Sheridan=cheridán
sheriff=cherif
Sherlock=cherlock
Sherman=cherman
Sherri=cherri
Sherrif=cherif
Sherry=cherry
SHERVA=cHERVA
SHERVA-DL=cHERVA-DL
Sheryl=cheryl
Shetland=Set land
SHEVA=cHEVA
Shevardnadze=chevard nadz
SHEVA-X=cHEVA X
shh=silen-cio
Shibam=Sibám
Shields=cheelds
Shift=chift
Shilshole=chilshol
Shimbun=chimbun
Shining=chinin
Shinji=chinji
Shippenville=chipenvill
Shirl=chirl
Shirley=chirlei
Shirly=chírly
Shitnbun=chitnbun
Shmuel=éSmuel
Shmuels=eSmuels
Sho=cho
Shoals=chols
Shock=chock
Shockley=chocli
Shock-o-Choc=chock-o-Choc
Shoemaker=choméiker
Shop=chop
Shop'n=chop
Shoppe=chop
Shores=chors
Short=chort
shorts=chorts
Shortz=chortz
Shoto=Sóto
Shouper=choper
Show=chow
Showboat=Snoubohat
Showscan=chouscan
Shrek=chuhek
Shreveport=Srive port
Shrimpton=chrimpton
Shrine=eSrin
Shriver=Sriver
Shu=chu
Shuber=chuber
Shue=Súe
Shuffle=chufl
Shumway=Shumguhey
Shure=chur
Shurtleff=churtleff
Shute=chut
Shyres=chayres
Siddhartha=Sidarta
Side=Said
Sidekick=Saidkick
Sidey=Sidy
Sie=Sai
Siemons=Simons
Signature=Signatur
Signe=Sign
Sigourney=Sigurn
Sihanouk=Sinouk
SÍÍÍ=SÍÍ
Silberbauer=Silber bauer
Silberberg=Silber berg
Sillicon=Silicon
Silling=Silinc
Silverberg=Silver ber
Silverstreams=Silverstrims
Sime=Sim
Simmons=Simons
Simms=Sims
Simon=Saimon
Simone=Simon
Simonson=Simon son
Simplicity=Simplicidy
Simpson=Simson
Simulation=Simuléichon
Sinatra=Sínatra
Sinclair=Sinclar
Singer=Singuer
Sing's=Sincgs
Sínope=Sínop
Siobhan=Sioban
Siouxsie=Sioxsie
Sissy=Sisí
Sisterwood=Sister wud
Situation=Situacion
Skeeter=Skiter
Ski=Skai
SKIDOO=SKIDu
skin=sken
Skinner=Skiner
Skjören=Skjoren
Skowhegan=Skow jegan
Skunkworks=Skunk works
Sky=Skay
Skyhook=Scayjuk
Skywalker=Skai uolker
Slager=eSlaller
Slater=eSlater
Slavin=eslabin
Slaye=slay
Slecle=eSlecl
Sledge=eSledge
Sleegers=Sliguers
Slim=eSlim
Sloane=eslóan
Slobbo=Slobo
Slobin=eSlobin
Slophanger=eSlophanyer
Sloppinger=Slopin guer
Slow=eSlow
Sluder=ésluder
Sludge=Slud
Sluice=eSluic
Sly=eSlay
Slyder=Slaider
Slyder's=Slaider's
Slytherin=éSliterin
Slythering=eSlythering
Slytherins=eSlytherins
Small=Smol
Smart=eSmart
Smartphone=esmart fon
Smash=Smach
Smith=esmith
Smithson=eSmithson
Smithsonian=eSmithsonian
SMITII=eSMITII
Smitty=eSmíty
Smoke=eSmok
Smokey=Smoky
Smucker's=esmucker's
SMUCKY=eSMUCKY
Smuts=eSmuts
Snake=Snak
Snape=eSneip
Snappies=eSnapis
Sneakers=éSnikers
Sneed=Snid
Snickers=eSnickers
Snicket=eSnicket
snip-CRUNCH=snip CRUNscH
Sno-Cat=eSno Cat
Snohomish=eSnojomish
Snook=esnuk
Snoopy=eSnupy
SnowDevils=esnow Devils
Snowe=eSnoúi
so=sou 
Soap=Sop
Society=Sósaety
Sodome=Sodom
Soho=Sojo
soja=soya
Sokko=Soko
Soloman=Sóloman
SOMBRIA=SOMBRíA
Some=Som
Somerset=Sumerset
Somers-Willett=Sumers- Willett
Somersworth=Som sworth
Something=Sómthing
Sometimes=Som-taims 
Somewhere=som wer
Sommer=Somer
Sonderbehandlung=Sonder bejand lung
Sonderkommando=Sunder komando
Sonderkommandos=Sunder komandos
Sonja=Sónlla
Sonny=Sony
Sonny's=Sonys
Sonya=Sonia
Soobie=Sobi
Sophie=Sofi
Sophomore=Sophomor
Sorbona=Sorhbona
Sorrento=Sorento
sos=shos
Soubise=Soubis
Soucy=Souci
Soul=Souul
Sounders=Sunders
South=Soudh
Sovine=Sovin
Spaced=Space
Spacewar=Space war
Spain=Spein
Spangier=Spanyer
Spanish=Spanich
Spanish-style=Spanish-stail
Sparine=Sparin
Sparrows=Spa rrows
Spears=Spirs
Spectator=Specteitor
SPEEDOGLIDE=SPiDOGLID
Speedy-Ser=Spidy Ser
Speke=Spek
Speller=Speler
Sperry=eSpery
Spice=Spais
Spiderman=Spaidermán
Spidey=Spidy
Spiegelman=espikjelman
Spielberg=Spielber
Spies=Spis
SPIKE=SPIK
Spillane=Spillan
Spilling=Spilin
Spinners=Spiners
spinning=spaineng 
Spnruce=Spen ruz
Spode=Spod
Spokane=Spoken
Spokani=eSpokani
Spoon=Spun
Spoons=Spuns
Sprague=prag
Sprigg=Sprig
Spring=espring
Springfield=Springfil
Springsteen=Springstin
Sprite=Sprit
Spruce=Spruz
Spyder=Spaider
Sqicedragon=eSqicedragon
Square=Squher
Squeaky=Squeky
Squibb=Squib
SQUID=SQUhID
Squire=Squir
Sri=Siri
SSA=S S A
ssh=silencio
Sshhh=silenncio
Sssh=Silencio
SST=eSe ese Ti
S-Sumi=eS-Sumi
ST.=SAINT
Staats-polizei=Stats-poliz
Stacey=steici
Stackpole=Stackpol
Stadium=Stediun
Stafford=Staford
Stage=Stag
Stakes=Staks
Stallings=Stálins
Stallone=Stalón
Stampnell=Stapnell
Stamson=estámson
Stan=Stán
Standard=eStandard
Stanford=Stánford
Stanhope=Stanjop
Stani=éStani
Stanley=Stanly
Stanny=eStany
Stapleton=Staplton
Starbucks=Star bucks
Starbursts=Starburts
Stardust=Starducst
Starkweather-Moore=Stark weder Mur
Starlog=Star log
Starret=Stáret
Starsea=Starsi
Starseal=Starsel
Starship=Starchip
State=Steit
States=estéids
Statesboro=Steitsboro
Statesville=Statsvill
Station=Stachión
Statler=estátler
Staub=Estaub
Staunton=Stáun ton
Steaming=Stem ing
Steel=Stail
Steele=Stil
Steeler=Stiler
Steelers=Stilers
Steelheart=Stiljert
Stefano=Stéfano
Steier=Steir
Steigmeyer=Stigmeyer
Steinborg=eStenborg
Steinway=Steinwey
Stel=Stil
Stella=Stela
Stemens=Stimens
Stenger=Stínger
Stephanie=Stéphani
Stéphanie=Stéphani
Stephano=Stéphano
Stephie=Stefi
Stepping=Stepin
Sterling=Stérling
Stetson=Stitson
Stevenage=Stivenagch
Stevens=Stivens
Stevenson=Stivenson
Stevie=Stevi
Stewart=Stuwart
Sthepen=Stepen
Stilison=Stilson
Stillson=estílson
Stoddard=Stodard
Stoelzle=Stulzle
Stoke=Stok
Stokes=Stoks
Stole=Stol
Stone=Ston
Stonebanks=Stón banks
Stonecutters=Ston cutters
Stonehenge=Ston hencch
Stonehill=Stonjill
Stones=eStóns
Stoney=Stúney
STOP=eSTóP
Stoppelmon=Stopelmon
Stortfold=Stort fold
Storyville=Story vil
Stotan=Stouten
Stovington=Stovintón
Stowe=Stoguhe
Straight=Straigh
Strasse=Stras
Stratemeyer=Stratemeyr
Strathmore=Strathmur
Strauss=Stráus
Strauss-Gabel=Strauss Gabel
Stream=Strim
Strike=Strik
Strikes=Striks
Strimmer=Strimer
Striped=Straped
Stripper=Striper
Strokes=estróks
Strong=Stróng
Strovington=Stróvin ton
Strumm=Strum
Strychnos=Strichnós
Stuart=Stu art
Stubbs=Stubs
Stubendiensts=Stubendients
Studebaker=Studbeiker
Sturgeon=Sturgueon
Sturmfuller=estum fuler
Style=Stail
Subaru=Subarú
Subramanian=Subramenian
Subway=Subwey
Sue=Súe
Suffern=Sufern
Sugar=chugar
Sugaree=chúgari
Sugashvili=Sugashvil
Suisse=Suiss
suit=
suites=suits
Sullivan=Súlivan
Sully=Suly
Summerfest=Sumerfest
Summers=Sumers
Sumner=Sum ner
Sundance=Sundans
Sunday=Sundey
Sundays=Sundeys
Sundeep=Sundip
Sunningdale=Suningdeil
Sunny=Sany
Sunnyvale=Suny val
SunRider=SunRaider
Sunrise=Sunrais
Sunshine=Sanchain
SunTrust=Sun Trust
Supaidaman=Supáidamán
Superman=Súperman
Supply=Suply
Support=Suport
Supreme=Suprem
Sure=Chuer
Surefire=Surfair
Surrendra=Surendra
Survived=Survaived
Susanna=Susana
Susannah=Susana
Susanne=Susan
Sushine=Suchain
Susi=Susí
Susie=Susi
Sussex=Susex
Sussy=Súsi
Sutherland=Suderland
Sutterfield=Sutterfild
Suzanne=Suzan
Suzie=Suzi
SW=eSe doble u
Swallow=Sualow
Swan=eSwan
Swann=esgwan
Swanny=Swany
Sweaty=Suety
Sweeney=Swiny
Sweep=Swip
Sweet=Swit
Sweetie=esguhiti
Sweet'n=Swit'n
Swift=Swif
Swinburne=Swin burn
Switchblade=Switchbleid
Swope=Swop
Swordquest=Sword quést
Sybill=Saibill
Sydney=Sydny
Syed=Sayed
Sylla=Syla
Sylvie=Sylvi
Sympathy=Sympaty
Symphonia=Symphonía
Syne=Syn
Syrinx=Sy hrincs
T. S. ELIOT=TS éLIOT
Tabby=Taby
Tadder=Tader
tags=tacs
Taiwan=Taiwán
Taj-Mahal=Taj-Majal
take=teik 
Takes=Taks
Takoshi=Takochi
Tale=Teil
Tallahassee=Tala así
Talleyrand=Taleirand
Tamara=Tamára
Tammy=Tamy
Tanglewood=Tenglewud
Tanner=Taner
Tannous=Tanos
Tardiff=Tardif
Tareyton=Tarey ton
Tareytons=Taretons
Target=Taryet
Targoff=Targof
Tarker's=Tarquérs
Taste=Tasti
Tastee=Tasti
Tatooine=Tatoin
Taylor=Teylor
Tbilisi=Tebilisi
TCBY=TC B Ye
TCUATRO=CUATRO
TDLS=TD LS
Teague=Tiagui
Team=Tim
Teddy=Tedy
teewets=tuits
Tel=Thel
Teledyne=Teledyn
TELEPHONE=TELEfON
TelePizza=TelePicza
Teletubbies=Teletubis
Tellingham=Telingham
Telly=Tely
Temple-Church=Templ -Church
Temples=Templs
Temptations=Temteichuns
Tenerife=Tenérife
Tennent=Tenent
Tennery=Ténhery
Tennesse=Tenesi
Tennessee=Tenessi
Tennison=Tenison
Tennyson=Tenyson
Ten-Pound=Ten Poun
Tepemkau=Tepenkiu
Terenure=Terenur
Terminator=Términeitor
Terminators=Termineitors
Terrace=Terras
Terrafino=Térra fino
Terville=Tervill
Terwilliger=Ter wiliger
Terwillinger=Terwillinyer
Texarkana=Texar kein
TH=THe
Thackeray=Thackray
Thalia=Thalía
Thank=Thenk
That’s all right=Dats ol rait
That’s all=Das ol. 
that=dad 
the=de
Theater=Thider
Theatre=Theatrul
TheFayz=deFayz
Theodore=Theodor
Theresa=Teresa
Therriault=Therriult
These=des
Thibodeau=Tibodeu
Thiebaut=Tibaut
Thieu=Tieu
thing=deng 
thinking=zenkeng 
Thinner=Tiner
Thirty-fourth=Thiry-fourth
This one=Dis uan 
This time=Dis taim 
This=dis
Thomas=Tomás
Thomaston=Thomastón
Thompson=Thomson
Thorazine=Thorazin
Thoreau=Thorau
Thorfinnssen=Torfinsen
Thorndike=Thorndik
Thorpe=Thorp
Three=Thri
Threepio=Threpio
thriller=trailer
Throneberry=Thronebery
Thruway=Truwey
Thunderbolt=Thunder bolt
Thunderbolts=Thunder bolts
Thursday=Thursdey
Tibbets=Tibets
Tice=Tiz
Tide=Tid
Tiffany=Tíffany
Tiger=Tiguer
Tigers=Tiguers
Tigger=Tíguer
Tikaanenen=Tika nenen
Tilney=Tilny
Timberlake=Tímberleik
Timex=Tai mex
Timmesdale=Taimsdal
Timmins=Timins
Timmons=Timons
Timmy=Timy
Tine=Tin
Tinike=Tinik
Tipperary=Tiperary
Tire=Tir
Titanico=Titánico
Titanium=Títanium
Titivillus=Titivilus
Titusville=Titusvil
to=tu 
Tobey=Toby
Today=Tu dey
Toddlifer=Todlifer
Tode=Tod
Tokai=Tokái
Tolkien=Tolkin
TOMBSTONE=TOMBSTON
Tommie=Tomi
Tommies=Tomis
Tommo=Tomo
Tommy=Tomy
Tomography=Tomograph
Tonie=Toni
Tonny=Tony
Too=Tu
Tooísie=Tuísi
Tookey=Toky
Tookey's=Tukys
Tooklander=Tuk lander
Toopsie=Tupsi
Toothaker=Totaker
Topsham=Topsam
Torello=Torelo
Torrance=Torranz
Toshiro=Tochiro
touch=tash
Tourette=Tourett
Tourville=Tourvill
Tower=Tawer
Town=Tawn
Townley=Tawnly
towns=tawns
Tr3ads=Treads
T-R-A=TRA
Trace=Tras
Tracy=treici
Trail=Treil
Trailways=Trelaguhes
Train=Trein
Tranquille=Tranquill
Travis=Trávis
Traynor=Tráynor
Treaches=Treachs
Treasury=Treachur
Tree=Tri
Treena=Trina
Trelawney=Trelauny
Trench=Trensch
Trennant=Trenant
Trentlake=Trentlak
Trevelyan=Trívelan
Trevelyan-Grey=Trívelan-Grey
Tribbles=Triblis
Triborough=Triborugh
Tribune=Traibun
Trimble=Trimbull
Trimbuil=Trimbul
Trimbull=Trimbul
Trimline=Trimlin
Trio=Trío
Trish=Trigch
Trisha=Tricha
Tri-Town=Tri-Tawn
Trixie=Trixi
Troop=Trup
Troopers=Trupers
Trotters=Troders
Trouble=Troubl
Troutman=Trouman
Trrrrr=terrr
TRS=TeeReéSe
True=Tru
Try=Tray
Tsao=T sao
Tsathoggua=satogua
Tsavo=Te savo
Tscherkowsky=escherkowsky
T-shirts=Ti-cherts
Tsuchiya=Tuchiya
Tuchman=Tucshman
Tuesday=Tuesdey
Tulane=Tulan
Tulley=Tuley
Tunnel=Tunel
Tunney=Tuny
Tupperware=Tuperwar
Turgeon=Turyeon
Turk=Túrk
Turkey=Turky
Turnblad=Turn blad
Turnpike=Turnpik
Turtle=Turtl
Tussaud=Tusaud
Tuttle=Tútel
Tuu=Tu
TuuTuu=TuTu
Tuu-Tuu=Tu-Tu
Tuvache=Tuvach
TWA=Aerolínea de Transporte Aéreo
tweed=tuit
tweets=tuits
Twickenham=Tuic kenham
Twilight=Tuailight
Twinings=Tinins
Twinkies=Twinkis
Twinkles=Twinklis
Two=tu
Ty=Tai
Tybee=Tybe
Tygers=Tyguers
Tyler=Tayler
Tyrell=Tairell
Tyson=Taison
Tzu=Tezu
Uaou=úaou
UCI=usí
UCSD=UC SD
UFC=U F C
UH=U H
Uintah=iuta
Ulahop=Ulajup
Ultimate=Ultimeit
Ultraman=Ultra man
Ultraman-Daito=Ultraman- Daito
Ultra-Slice=Ultra-eSlis
Umbrige=únbrich
Uncle=Uncl
Undead=Unded
Underhill=únder jill
understand=ander-stand
Underwood=Underwud
Unger=Unguer
Uniscope=Uniscop
Universe=Univers
Unlearning=Unlerning
Unterscharführer=Unterschar fuhrer
Updike=Updik
Upjohn=ap john
UPMILE=aPMIL
Upper=Uper
Upshaw=Upsaw
Urberville=Urbervill
Urnby-for-Cry=Urnby-for-Cray
URSS=UrS
Ursula=úrsula
USC=US C
Usher=úcher
USP=US P
Utah=iUtah
uthah=Iuta
UTP=útepe
Uuua=Uua
Uuuu=Uúuúu
Uuuuuuuu=Uuu
uva=huhva
UW=Udoble úh
VADER=veider
Valcourt=Valcurt
Valentin=Valentín
Valentine=Valentin
Valerie=Váleri
Valium=Válium
VALLEDE=VALLE DE
Valley=Valy
Valorum=Valorúm
Valusia=Valusía
Vampire=Vanpair
Vampyre=Vampair
Vance=Vanz
Vancouver=Váncuver
Vandervoort=Vandervurt
Vann=Van
Vanni=Vani
Vantage=Vantad
Vartaxxx=Vartax
Veazie=Veasi
Vence=Vens
Venn=Ven
Ventures=Venturs
Verge=Verch
Verve=Vervi
Very well, thanks=Veri uel zanks
V-E-T-E=vete
VFW=VF dobleú
VHS=beacheese
Vichyssoise=Vichy sois
Vicious=Vicius
Vickery=Vicker
Vicy=Visy
Vietnam=Vitnam
View=Viu
View-Master=Viu Master
VIH=VeIacHe
Vijzelstraat=Vijelstrat
Villadiego=Villa diego
Village=Villach
Villiers=Vilirs
Vinalhaven=Vinal jeiven
Vince=Vins
Vincent-Peale=Vincent-Peal
Vinnie=Vini
Vintage=Vintach
Violet=Vaiolet
Viólet=Vaiolet
Vioxx=Viox
VIP=biaypí
Virgil=Viryíl
Virology=Virolollí
Virtue=Virtui
Vitamin=Vítamin
vitamina-D=vitamina- D
Vitamine=Vitamain
Vivienne=Vivien
VMTO=bemTO
Vogelman=Vóyel man
Voight=Voigt
Voight-Kampff=Voigt Kamff
VoIP=Voz IP
Volare=Volari
Volatile=Volatil
Volkswagen=Volkswaguen
volleyball=voli vol
volleyvall=voli vol
Voltaire=Voltair
Volunteer=Voluntier
Vondelstraat=Vondelstrat
Vonnegut=Vonegut
Voodoo=Vudú
Voskuijl=Voskuij
Vosostros=Vosotros
Voyager=Voyajer
Voyagers=Voyaguers
VW=V dobleú
W=doble úh
Wade=Wad
Waffle=guaffle
Wagner=guagner
Wagon=guagon
Wagooner=guagoner
Wainwright=Wain gright
Waite=Wait
waiting=gueireng 
Wake=Wak
Wakefield=Wakfild
Waldenbooks=Waldenbuks
Waldsee=Waldsi
Walgrove=Walgrov
Wallace=Walaz
Walles=Wales
Wallis=Walis
Wallowa=alowa
Wallstreet=Walsstrit
Wally=Waly
Walpole=Walpol
Walrus=Wal rus
wanna=guana 
Wannsee=Wans
WarDoor=WarDor
Ware=War
WAREHOUSE=WAR jaus
Warezhaus=War zhaus
Warhol=Warjol
Waring=Wering
WARNER=WáRNER
Wartenberg=Wartenber
Warthogs=Wartjocs
Warwickshire=Warwickchir
Washburn=Was burn
Washington=Wachinton
Watcher=Wátcher
Water=guáter
Waterbury=Waderbury
Watergate=Watergeit
Waterloo=Waterlu
Waterman=uaterman
Waters=guhaders
Waterville=Watervil
Waterworld=Waderworld
Watie=Wati
Watseka=Watse ka
Watts=Whatts
Way=Wey
Wayne=Wayn
Wayward=ueiguhard
WCAU=doble úh CAU
WCSH=dobleú CSH
We=Wi
Weasley=Wisly
Weasleys=Wislys
Weather=Wither
Weaver=Wever
Webb=Web
Webber=ueber
Weber=ueber
Weddell=Wedell
Wednesday=Wednesdey
Weekly=Wikly
Weeks=Wiks
Weezer=Wizer
Wegener=Wellener
Weigel=Weiyel
Weinberg=Weinber
Welldone=Welldon
Weller=Weler
Welles=Wellis
Wellesley=Welesly
Wellington=Welinton
Wells=Wels
Wenatchee=Wenatch
We're=We'r
Werhmachtsberichte=Werhmacht bericht
Wesley=Wisly
Wesleyan=Wisleyan
Wesson=Wisson
Westborough=West burogh
WESTBROOK=WESTBRuK
Westerfeld=Westerfild
Westinghouse=Westing jauss
Westlake=Westlak
Westlife=Westlaif
Westover=uestuver
Weteringschans=Wederings chans
Wetmore=Wetmor
Wetmores=Wetmors
Wettermark=Wedermark
WFYI=uiFf YI
What?=Juat?
what=Uat
Whatsapp=Whatsap
Whedon=Wedon
Whedonverse=Whedonvers
Wheeler=guhiler
Wheels=Wils
Wheezes=ghuezes
Whelan=ghuelan
When?=Juen? 
Where is?=Juer is? 
WHERE=guhER
Whetstone=Wétston
Which one?=Uich uan? 
WHIMPER=guhIMPER
WHISTLE=WHISTL
Whistler=guhistler
Whistles=Whistlis
Whitaker=guhitéiker
White=Wahit
Whitechapel=guhaitchapel
White-Club=Whait Club
Whitehall=guhite jall
Whitely=Witely
Whitman=guhitman
Whitmire=guhitmir
Whitney=Whitny
Whizbees=guizbis
Who=ju
Whopper=guujoper
Whoppers=Gúupers
Why?=Jaui? 
Wichita=Wíchita
Widdershin=Widersin
Widdershins=Waider sins
Wiesenthal=guhisenthel
Wi-Fi=guhaifai
Wiggly=Wigly
Wigmore=Wigmor
Wii=Wih
WiIIie=Wili
Wijk-Voskuijl=WikVoskuijl
Wilbour=Wilbur
Wildcats=Wild cats
Wilde=Wild
Wildlife=waldlaif
Wilfreda=Walfreda
Wilkes=Wikes
Willamette=Wilamett
Willetson=Wiletson
Willi=Wili
William=Wíliam
Williams=Wiliams
Williard=Wiliard
Willie=Wili
Willis=Wilis
Willy=Wily
Wiltshire=Wiltchir
Winchester=Win chester
Wind=guhind
Windows=Windohus
Windsor=guhinsor
Winehouse=Wainjaus
Winesburg=Winsburg
Winfrey=Winfry
Wingardium=Wíngardiun
Winge=Wing
Winkle=Winkl
Winnebago=Winibago
Winnebagos=Winibagos
Winner=Winer
Winnie=Wini
Winnie-the-Pooh=gúhini de pu
Winnifred=Winfred
Winnipeg=Winipeg
Winnipesaukee=Winipesauki
Winsley=Winsly
Winsor=Wínsor
Winston=Wiston
Winter=Witer
Winterport=Winter port
WIOD=WI OD
WIRED=guIRED
Wisconsin=Wiscónsin
Withers=Waiders
Witherspoon=Widers pun
Withington=guhithingtun
Witney=Witny
WKML=dobleú KML
WM=doble u M
WMTQ=dobleu MTQ
WNET=doble úh NET
Wodehouse=Wod jaus
Wolfe=Wolf
Wollensak=Wolensak
Woo=Wu
Wood=Wud
Woodall=Wudell
Woodrow=Wud rou
Woods=Wuds
Woodsman=Wudsman
Woodstock=Wudstock
Woodview=Wudviw
Woodville=guuhdvill
Woodward=Wudward
Woody=Wudy
WOOK=WuK
Woolsthorpe=Wuulsthorp
Woolworth=Wulworth
WOPR=Guo per
World=guord
world=guorld
WorldBuilder=WorldBilder
Worthington=Wortincton
Wothering=Wódering
Woudstra=Wodstra
WP=dobleu P
Wrangler=guhrangler
Wrap=grap
Wray=gray
Wreck=greck
Wright=graid
Wrightson=graigson
Writer=graiter
Writers=griters
Writing=graiting
Wrotk=grotk
Wunderwaffe=Wunderwaf
Wurlitzer=gurlitzer
Wüst=Wust
Wuwa=gugua
WWVE=doble u, doble u, uve, he
Wyatt=guayatt
Wyck=guhick
Wynette=Wynett
Wynoochee=Wynoche
Wyoming=Waiomin
Xbox=eXbox
X-Factor=eX-Fáctor
Xix=19
Xvi=14
Xvii=17
XXIII=23
y/o=ih  óh
Yaanek=Yanek
Yacouba=Yacuba
Yahoo=Yajú
Yahvé=Yavé
Yale=Yalé
Yancey=Yansy
Yann=Yan
Yarmouth=Yarmuth
Yearbook=Yerbuk
Yellow=Yelow
Yellowjack=Yelowjack
Yes=ies 
Yhin=llin
Yiiiihah=Yiihah
YMCA=IMCA
Yogi=Yogui
Yolyn=Yulyn
York=Yohrk
Yorkshire=Yorkchir
Yosemite=Yosemit
Yoshi=Yo shi
You=Yu
you=yu 
Youngerman=Youn german
your=yor 
Your=Yur
you're=Yor
You're=yu ar
Yo-Yu=Yo Yu
Yue=Yúe
Yujuuu=Yujuuú
Yunnan=Yunan
Yvette=Yvett
Yvonne=Yvón
Zaandam=Zándam
Zahlappels=Zahlapels
Zaire=Zair
Zane=cein
Zannini=Zanini
Zappa=Zapa
Zapple=Zapl
Zaxxon=Zaxon
Zayre=Zayr
Zeiss-Plaumm=Zeis Plaum
Zellicoe=Zelico
ZELMIRE=ZELMIR
Zeppelin=Zépelin
Zhang=chang
Zilly=Zily
Zimmer=Zimer
Zimmerman=Zsimermán
Zinger=Zínguer
Zingers=Zinguers
Zinneman=Zineman
Zinnenman=Zineman
Zippo=Zipo
Zoey=Zoe
Zoltan=Zoltán
Zombie=zonbi
Zombiees=zonbis
Zombies=Zombis
Zone=Zon
Zooey=Zoey
Zork=Zór
Zuider-Amstellaan=Zuider Amstelan
אול= 
